urn:cts:latepig:inscriptions.doc1.hclat:1@d[1]	urn:cite:latepi:tokens.d
urn:cts:latepig:inscriptions.doc1.hclat:1@o[1]	urn:cite:latepi:tokens.o
urn:cts:latepig:inscriptions.doc1.hclat:1@m[1]	urn:cite:latepi:tokens.m
urn:cts:latepig:inscriptions.doc1.hclat:2@methonem[1]	urn:cite:latepi:tokens.methonem
urn:cts:latepig:inscriptions.doc1.hclat:2@communiri[1]	urn:cite:latepi:tokens.communiri
urn:cts:latepig:inscriptions.doc1.hclat:3@vallis[1]	urn:cite:latepi:tokens.vallis
urn:cts:latepig:inscriptions.doc1.hclat:3@moenus[1]	urn:cite:latepi:tokens.moenus
urn:cts:latepig:inscriptions.doc1.hclat:3@et[1]	urn:cite:latepi:tokens.et
urn:cts:latepig:inscriptions.doc1.hclat:3@propugnaculis[1]	urn:cite:latepi:tokens.propugnaculis
urn:cts:latepig:inscriptions.doc1.hclat:3@terra[1]	urn:cite:latepi:tokens.terra
urn:cts:latepig:inscriptions.doc1.hclat:3@mario[1]	urn:cite:latepi:tokens.mario
urn:cts:latepig:inscriptions.doc1.hclat:4@mandavit[1]	urn:cite:latepi:tokens.mandavit
urn:cts:latepig:inscriptions.doc1.hclat:4@senatus[1]	urn:cite:latepi:tokens.senatus
urn:cts:latepig:inscriptions.doc1.hclat:4@antonio[1]	urn:cite:latepi:tokens.antonio
urn:cts:latepig:inscriptions.doc1.hclat:4@lauretano[1]	urn:cite:latepi:tokens.lauretano
urn:cts:latepig:inscriptions.doc1.hclat:4@pro[1]	urn:cite:latepi:tokens.pro
urn:cts:latepig:inscriptions.doc1.hclat:4@gnali[1]	urn:cite:latepi:tokens.gnali
urn:cts:latepig:inscriptions.doc1.hclat:4@armo[1]	urn:cite:latepi:tokens.armo
urn:cts:latepig:inscriptions.doc1.hclat:4@in[1]	urn:cite:latepi:tokens.in
urn:cts:latepig:inscriptions.doc1.hclat:4@felopo[1]	urn:cite:latepi:tokens.felopo
urn:cts:latepig:inscriptions.doc1.hclat:5@qui[1]	urn:cite:latepi:tokens.qui
urn:cts:latepig:inscriptions.doc1.hclat:5@tanti[1]	urn:cite:latepi:tokens.tanti
urn:cts:latepig:inscriptions.doc1.hclat:5@operis[1]	urn:cite:latepi:tokens.operis
urn:cts:latepig:inscriptions.doc1.hclat:5@curam[1]	urn:cite:latepi:tokens.curam
urn:cts:latepig:inscriptions.doc1.hclat:5@sustinens[1]	urn:cite:latepi:tokens.sustinens
urn:cts:latepig:inscriptions.doc1.hclat:6@ad[1]	urn:cite:latepi:tokens.ad
urn:cts:latepig:inscriptions.doc1.hclat:6@urbis[1]	urn:cite:latepi:tokens.urbis
urn:cts:latepig:inscriptions.doc1.hclat:6@et[1]	urn:cite:latepi:tokens.et
urn:cts:latepig:inscriptions.doc1.hclat:6@regni[1]	urn:cite:latepi:tokens.regni
urn:cts:latepig:inscriptions.doc1.hclat:6@tu[1]	urn:cite:latepi:tokens.tu
urn:cts:latepig:inscriptions.doc1.hclat:6@tamen[1]	urn:cite:latepi:tokens.tamen
urn:cts:latepig:inscriptions.doc1.hclat:7@fortiora[1]	urn:cite:latepi:tokens.fortiora
urn:cts:latepig:inscriptions.doc1.hclat:7@munimenta[1]	urn:cite:latepi:tokens.munimenta
urn:cts:latepig:inscriptions.doc1.hclat:7@erexit[1]	urn:cite:latepi:tokens.erexit
urn:cts:latepig:inscriptions.doc1.hclat:7@et[1]	urn:cite:latepi:tokens.et
urn:cts:latepig:inscriptions.doc1.hclat:7@clau[1]	urn:cite:latepi:tokens.clau
urn:cts:latepig:inscriptions.doc1.hclat:7@sit[1]	urn:cite:latepi:tokens.sit
urn:cts:latepig:inscriptions.doc1.hclat:8@anno[1]	urn:cite:latepi:tokens.anno
urn:cts:latepig:inscriptions.doc1.hclat:8@salutis[1]	urn:cite:latepi:tokens.salutis
urn:cts:latepig:inscriptions.doc1.hclat:8@mdccxiv[1]	urn:cite:latepi:tokens.mdccxiv
urn:cts:latepig:inscriptions.doc10.hclat:1@pius[1]	urn:cite:latepi:tokens.pius
urn:cts:latepig:inscriptions.doc10.hclat:1@iiii[1]	urn:cite:latepi:tokens.iiii
urn:cts:latepig:inscriptions.doc10.hclat:1@medices[1]	urn:cite:latepi:tokens.medices
urn:cts:latepig:inscriptions.doc10.hclat:1@pontifex[1]	urn:cite:latepi:tokens.pontifex
urn:cts:latepig:inscriptions.doc10.hclat:1@max[1]	urn:cite:latepi:tokens.max
urn:cts:latepig:inscriptions.doc10.hclat:1@maximus[1]	urn:cite:latepi:tokens.maximus
urn:cts:latepig:inscriptions.doc10.hclat:1@portam[1]	urn:cite:latepi:tokens.portam
urn:cts:latepig:inscriptions.doc10.hclat:1@angelicam[1]	urn:cite:latepi:tokens.angelicam
urn:cts:latepig:inscriptions.doc10.hclat:1@iuxsta[1]	urn:cite:latepi:tokens.iuxsta
urn:cts:latepig:inscriptions.doc10.hclat:1@cassiam[1]	urn:cite:latepi:tokens.cassiam
urn:cts:latepig:inscriptions.doc10.hclat:1@aperuit[1]	urn:cite:latepi:tokens.aperuit
urn:cts:latepig:inscriptions.doc11.hclat:1@urbanus[1]	urn:cite:latepi:tokens.urbanus
urn:cts:latepig:inscriptions.doc11.hclat:1@viii[1]	urn:cite:latepi:tokens.viii
urn:cts:latepig:inscriptions.doc11.hclat:1@pont[1]	urn:cite:latepi:tokens.pont
urn:cts:latepig:inscriptions.doc11.hclat:1@pontifex[1]	urn:cite:latepi:tokens.pontifex
urn:cts:latepig:inscriptions.doc11.hclat:1@max[1]	urn:cite:latepi:tokens.max
urn:cts:latepig:inscriptions.doc11.hclat:1@maximus[1]	urn:cite:latepi:tokens.maximus
urn:cts:latepig:inscriptions.doc11.hclat:2@geminas[1]	urn:cite:latepi:tokens.geminas
urn:cts:latepig:inscriptions.doc11.hclat:2@hasce[1]	urn:cite:latepi:tokens.hasce
urn:cts:latepig:inscriptions.doc11.hclat:2@inscriptiones[1]	urn:cite:latepi:tokens.inscriptiones
urn:cts:latepig:inscriptions.doc11.hclat:3@quae[1]	urn:cite:latepi:tokens.quae
urn:cts:latepig:inscriptions.doc11.hclat:3@olimas[1]	urn:cite:latepi:tokens.olimas
urn:cts:latepig:inscriptions.doc11.hclat:3@leone[1]	urn:cite:latepi:tokens.leone
urn:cts:latepig:inscriptions.doc11.hclat:3@iv[1]	urn:cite:latepi:tokens.iv
urn:cts:latepig:inscriptions.doc11.hclat:4@in[1]	urn:cite:latepi:tokens.in
urn:cts:latepig:inscriptions.doc11.hclat:4@leonianae[1]	urn:cite:latepi:tokens.leonianae
urn:cts:latepig:inscriptions.doc11.hclat:4@urbis[1]	urn:cite:latepi:tokens.urbis
urn:cts:latepig:inscriptions.doc11.hclat:4@munimentis[1]	urn:cite:latepi:tokens.munimentis
urn:cts:latepig:inscriptions.doc11.hclat:5@positae[1]	urn:cite:latepi:tokens.positae
urn:cts:latepig:inscriptions.doc11.hclat:5@fuerant[1]	urn:cite:latepi:tokens.fuerant
urn:cts:latepig:inscriptions.doc11.hclat:6@ex[1]	urn:cite:latepi:tokens.ex
urn:cts:latepig:inscriptions.doc11.hclat:6@obscurioribus[1]	urn:cite:latepi:tokens.obscurioribus
urn:cts:latepig:inscriptions.doc11.hclat:6@locis[1]	urn:cite:latepi:tokens.locis
urn:cts:latepig:inscriptions.doc11.hclat:7@huc[1]	urn:cite:latepi:tokens.huc
urn:cts:latepig:inscriptions.doc11.hclat:7@transtulit[1]	urn:cite:latepi:tokens.transtulit
urn:cts:latepig:inscriptions.doc11.hclat:8@anno[1]	urn:cite:latepi:tokens.anno
urn:cts:latepig:inscriptions.doc11.hclat:8@salutis[1]	urn:cite:latepi:tokens.salutis
urn:cts:latepig:inscriptions.doc11.hclat:8@mdcxxxiv[1]	urn:cite:latepi:tokens.mdcxxxiv
urn:cts:latepig:inscriptions.doc11.hclat:9@pont[1]	urn:cite:latepi:tokens.pont
urn:cts:latepig:inscriptions.doc11.hclat:9@pontifex[1]	urn:cite:latepi:tokens.pontifex
urn:cts:latepig:inscriptions.doc11.hclat:9@xii[1]	urn:cite:latepi:tokens.xii
urn:cts:latepig:inscriptions.doc12.hclat:1@sixtus[1]	urn:cite:latepi:tokens.sixtus
urn:cts:latepig:inscriptions.doc12.hclat:1@v[1]	urn:cite:latepi:tokens.v
urn:cts:latepig:inscriptions.doc12.hclat:1@pont[1]	urn:cite:latepi:tokens.pont
urn:cts:latepig:inscriptions.doc12.hclat:1@pontifex[1]	urn:cite:latepi:tokens.pontifex
urn:cts:latepig:inscriptions.doc12.hclat:1@max[1]	urn:cite:latepi:tokens.max
urn:cts:latepig:inscriptions.doc12.hclat:1@maximus[1]	urn:cite:latepi:tokens.maximus
urn:cts:latepig:inscriptions.doc12.hclat:2@cruci[1]	urn:cite:latepi:tokens.cruci
urn:cts:latepig:inscriptions.doc12.hclat:2@invictae[1]	urn:cite:latepi:tokens.invictae
urn:cts:latepig:inscriptions.doc12.hclat:3@obeliscum[1]	urn:cite:latepi:tokens.obeliscum
urn:cts:latepig:inscriptions.doc12.hclat:3@vaticanum[1]	urn:cite:latepi:tokens.vaticanum
urn:cts:latepig:inscriptions.doc12.hclat:4@ab[1]	urn:cite:latepi:tokens.ab
urn:cts:latepig:inscriptions.doc12.hclat:4@impura[1]	urn:cite:latepi:tokens.impura
urn:cts:latepig:inscriptions.doc12.hclat:4@superstitione[1]	urn:cite:latepi:tokens.superstitione
urn:cts:latepig:inscriptions.doc12.hclat:5@expiatum[1]	urn:cite:latepi:tokens.expiatum
urn:cts:latepig:inscriptions.doc12.hclat:5@iustius[1]	urn:cite:latepi:tokens.iustius
urn:cts:latepig:inscriptions.doc12.hclat:6@et[1]	urn:cite:latepi:tokens.et
urn:cts:latepig:inscriptions.doc12.hclat:6@felicius[1]	urn:cite:latepi:tokens.felicius
urn:cts:latepig:inscriptions.doc12.hclat:6@consecravit[1]	urn:cite:latepi:tokens.consecravit
urn:cts:latepig:inscriptions.doc12.hclat:7@anno[1]	urn:cite:latepi:tokens.anno
urn:cts:latepig:inscriptions.doc12.hclat:7@mdlxxxvi[1]	urn:cite:latepi:tokens.mdlxxxvi
urn:cts:latepig:inscriptions.doc12.hclat:7@pont[1]	urn:cite:latepi:tokens.pont
urn:cts:latepig:inscriptions.doc12.hclat:7@pontifex[1]	urn:cite:latepi:tokens.pontifex
urn:cts:latepig:inscriptions.doc12.hclat:7@ii[1]	urn:cite:latepi:tokens.ii
urn:cts:latepig:inscriptions.doc13.hclat:1@clementi[1]	urn:cite:latepi:tokens.clementi
urn:cts:latepig:inscriptions.doc13.hclat:1@nono[1]	urn:cite:latepi:tokens.nono
urn:cts:latepig:inscriptions.doc13.hclat:1@pont[1]	urn:cite:latepi:tokens.pont
urn:cts:latepig:inscriptions.doc13.hclat:1@pontifici[1]	urn:cite:latepi:tokens.pontifici
urn:cts:latepig:inscriptions.doc13.hclat:1@opt[1]	urn:cite:latepi:tokens.opt
urn:cts:latepig:inscriptions.doc13.hclat:1@optimo[1]	urn:cite:latepi:tokens.optimo
urn:cts:latepig:inscriptions.doc13.hclat:1@max[1]	urn:cite:latepi:tokens.max
urn:cts:latepig:inscriptions.doc13.hclat:1@maximo[1]	urn:cite:latepi:tokens.maximo
urn:cts:latepig:inscriptions.doc13.hclat:2@aelio[1]	urn:cite:latepi:tokens.aelio
urn:cts:latepig:inscriptions.doc13.hclat:2@ponti[1]	urn:cite:latepi:tokens.ponti
urn:cts:latepig:inscriptions.doc13.hclat:2@ad[1]	urn:cite:latepi:tokens.ad
urn:cts:latepig:inscriptions.doc13.hclat:2@s[1]	urn:cite:latepi:tokens.s
urn:cts:latepig:inscriptions.doc13.hclat:2@santi[1]	urn:cite:latepi:tokens.santi
urn:cts:latepig:inscriptions.doc13.hclat:2@angeli[1]	urn:cite:latepi:tokens.angeli
urn:cts:latepig:inscriptions.doc13.hclat:2@arcem[1]	urn:cite:latepi:tokens.arcem
urn:cts:latepig:inscriptions.doc13.hclat:3@angelorum[1]	urn:cite:latepi:tokens.angelorum
urn:cts:latepig:inscriptions.doc13.hclat:3@statuis[1]	urn:cite:latepi:tokens.statuis
urn:cts:latepig:inscriptions.doc13.hclat:4@redemptionis[1]	urn:cite:latepi:tokens.redemptionis
urn:cts:latepig:inscriptions.doc13.hclat:4@mysteria[1]	urn:cite:latepi:tokens.mysteria
urn:cts:latepig:inscriptions.doc13.hclat:4@praei[1]	urn:cite:latepi:tokens.praei
urn:cts:latepig:inscriptions.doc13.hclat:4@erh[1]	urn:cite:latepi:tokens.erh
urn:cts:latepig:inscriptions.doc13.hclat:5@exculto[1]	urn:cite:latepi:tokens.exculto
urn:cts:latepig:inscriptions.doc13.hclat:5@et[1]	urn:cite:latepi:tokens.et
urn:cts:latepig:inscriptions.doc13.hclat:5@exornato[1]	urn:cite:latepi:tokens.exornato
urn:cts:latepig:inscriptions.doc13.hclat:6@quod[1]	urn:cite:latepi:tokens.quod
urn:cts:latepig:inscriptions.doc13.hclat:6@sine[1]	urn:cite:latepi:tokens.sine
urn:cts:latepig:inscriptions.doc13.hclat:6@liv[1]	urn:cite:latepi:tokens.liv
urn:cts:latepig:inscriptions.doc13.hclat:6@titulo[1]	urn:cite:latepi:tokens.titulo
urn:cts:latepig:inscriptions.doc13.hclat:6@et[1]	urn:cite:latepi:tokens.et
urn:cts:latepig:inscriptions.doc13.hclat:6@insignibus[1]	urn:cite:latepi:tokens.insignibus
urn:cts:latepig:inscriptions.doc13.hclat:7@opus[1]	urn:cite:latepi:tokens.opus
urn:cts:latepig:inscriptions.doc13.hclat:7@absolvi[1]	urn:cite:latepi:tokens.absolvi
urn:cts:latepig:inscriptions.doc13.hclat:8@ex[1]	urn:cite:latepi:tokens.ex
urn:cts:latepig:inscriptions.doc13.hclat:8@animi[1]	urn:cite:latepi:tokens.animi
urn:cts:latepig:inscriptions.doc13.hclat:8@moderatione[1]	urn:cite:latepi:tokens.moderatione
urn:cts:latepig:inscriptions.doc13.hclat:8@mandaverat[1]	urn:cite:latepi:tokens.mandaverat
urn:cts:latepig:inscriptions.doc13.hclat:9@clemens[1]	urn:cite:latepi:tokens.clemens
urn:cts:latepig:inscriptions.doc13.hclat:9@x[1]	urn:cite:latepi:tokens.x
urn:cts:latepig:inscriptions.doc13.hclat:9@pont[1]	urn:cite:latepi:tokens.pont
urn:cts:latepig:inscriptions.doc13.hclat:9@pontifex[1]	urn:cite:latepi:tokens.pontifex
urn:cts:latepig:inscriptions.doc13.hclat:9@max[1]	urn:cite:latepi:tokens.max
urn:cts:latepig:inscriptions.doc13.hclat:9@maximus[1]	urn:cite:latepi:tokens.maximus
urn:cts:latepig:inscriptions.doc13.hclat:10@ut[1]	urn:cite:latepi:tokens.ut
urn:cts:latepig:inscriptions.doc13.hclat:10@beneficentissimi[1]	urn:cite:latepi:tokens.beneficentissimi
urn:cts:latepig:inscriptions.doc13.hclat:10@principis[1]	urn:cite:latepi:tokens.principis
urn:cts:latepig:inscriptions.doc13.hclat:11@memoria[1]	urn:cite:latepi:tokens.memoria
urn:cts:latepig:inscriptions.doc13.hclat:11@exta[1]	urn:cite:latepi:tokens.exta
urn:cts:latepig:inscriptions.doc13.hclat:11@t[1]	urn:cite:latepi:tokens.t
urn:cts:latepig:inscriptions.doc13.hclat:12@posuit[1]	urn:cite:latepi:tokens.posuit
urn:cts:latepig:inscriptions.doc13.hclat:12@anno[1]	urn:cite:latepi:tokens.anno
urn:cts:latepig:inscriptions.doc13.hclat:12@mdclxxii[1]	urn:cite:latepi:tokens.mdclxxii
urn:cts:latepig:inscriptions.doc14.hclat:1@m[1]	urn:cite:latepi:tokens.m
urn:cts:latepig:inscriptions.doc14.hclat:1@marcus[1]	urn:cite:latepi:tokens.marcus
urn:cts:latepig:inscriptions.doc14.hclat:1@agrippa[1]	urn:cite:latepi:tokens.agrippa
urn:cts:latepig:inscriptions.doc14.hclat:1@l[1]	urn:cite:latepi:tokens.l
urn:cts:latepig:inscriptions.doc14.hclat:1@lucii[1]	urn:cite:latepi:tokens.lucii
urn:cts:latepig:inscriptions.doc14.hclat:1@f[1]	urn:cite:latepi:tokens.f
urn:cts:latepig:inscriptions.doc14.hclat:1@filius[1]	urn:cite:latepi:tokens.filius
urn:cts:latepig:inscriptions.doc14.hclat:1@cos[1]	urn:cite:latepi:tokens.cos
urn:cts:latepig:inscriptions.doc14.hclat:1@consul[1]	urn:cite:latepi:tokens.consul
urn:cts:latepig:inscriptions.doc14.hclat:1@tertium[1]	urn:cite:latepi:tokens.tertium
urn:cts:latepig:inscriptions.doc14.hclat:1@fecit[1]	urn:cite:latepi:tokens.fecit
urn:cts:latepig:inscriptions.doc15.hclat:1@divo[1]	urn:cite:latepi:tokens.divo
urn:cts:latepig:inscriptions.doc15.hclat:1@antonino[1]	urn:cite:latepi:tokens.antonino
urn:cts:latepig:inscriptions.doc15.hclat:1@et[1]	urn:cite:latepi:tokens.et
urn:cts:latepig:inscriptions.doc15.hclat:2@divae[1]	urn:cite:latepi:tokens.divae
urn:cts:latepig:inscriptions.doc15.hclat:2@faustinae[1]	urn:cite:latepi:tokens.faustinae
urn:cts:latepig:inscriptions.doc15.hclat:2@ex[1]	urn:cite:latepi:tokens.ex
urn:cts:latepig:inscriptions.doc15.hclat:2@s[1]	urn:cite:latepi:tokens.s
urn:cts:latepig:inscriptions.doc15.hclat:2@senatus[1]	urn:cite:latepi:tokens.senatus
urn:cts:latepig:inscriptions.doc15.hclat:2@c[1]	urn:cite:latepi:tokens.c
urn:cts:latepig:inscriptions.doc15.hclat:2@consulto[1]	urn:cite:latepi:tokens.consulto
urn:cts:latepig:inscriptions.doc16.hclat:1@terentiae[1]	urn:cite:latepi:tokens.terentiae
urn:cts:latepig:inscriptions.doc16.hclat:2@flavolae[1]	urn:cite:latepi:tokens.flavolae
urn:cts:latepig:inscriptions.doc16.hclat:3@v[1]	urn:cite:latepi:tokens.v
urn:cts:latepig:inscriptions.doc16.hclat:3@v[2]	urn:cite:latepi:tokens.v
urn:cts:latepig:inscriptions.doc16.hclat:4@maximae[1]	urn:cite:latepi:tokens.maximae
urn:cts:latepig:inscriptions.doc16.hclat:5@cn[1]	urn:cite:latepi:tokens.cn
urn:cts:latepig:inscriptions.doc16.hclat:5@gnaeus[1]	urn:cite:latepi:tokens.gnaeus
urn:cts:latepig:inscriptions.doc16.hclat:5@statilius[1]	urn:cite:latepi:tokens.statilius
urn:cts:latepig:inscriptions.doc16.hclat:6@menander[1]	urn:cite:latepi:tokens.menander
urn:cts:latepig:inscriptions.doc16.hclat:7@fictor[1]	urn:cite:latepi:tokens.fictor
urn:cts:latepig:inscriptions.doc16.hclat:8@v[1]	urn:cite:latepi:tokens.v
urn:cts:latepig:inscriptions.doc16.hclat:8@v[2]	urn:cite:latepi:tokens.v
urn:cts:latepig:inscriptions.doc16.hclat:9@cn[1]	urn:cite:latepi:tokens.cn
urn:cts:latepig:inscriptions.doc16.hclat:9@gnaeus[1]	urn:cite:latepi:tokens.gnaeus
urn:cts:latepig:inscriptions.doc16.hclat:9@statili[1]	urn:cite:latepi:tokens.statili
urn:cts:latepig:inscriptions.doc16.hclat:10@cerdonis[1]	urn:cite:latepi:tokens.cerdonis
urn:cts:latepig:inscriptions.doc16.hclat:11@fictoris[1]	urn:cite:latepi:tokens.fictoris
urn:cts:latepig:inscriptions.doc16.hclat:12@v[1]	urn:cite:latepi:tokens.v
urn:cts:latepig:inscriptions.doc16.hclat:12@v[2]	urn:cite:latepi:tokens.v
urn:cts:latepig:inscriptions.doc16.hclat:13@alumnus[1]	urn:cite:latepi:tokens.alumnus
urn:cts:latepig:inscriptions.doc17.hclat:1@praetextatae[1]	urn:cite:latepi:tokens.praetextatae
urn:cts:latepig:inscriptions.doc17.hclat:1@crassi[1]	urn:cite:latepi:tokens.crassi
urn:cts:latepig:inscriptions.doc17.hclat:1@fil[1]	urn:cite:latepi:tokens.fil
urn:cts:latepig:inscriptions.doc17.hclat:1@filia[1]	urn:cite:latepi:tokens.filia
urn:cts:latepig:inscriptions.doc17.hclat:2@vv[1]	urn:cite:latepi:tokens.vv
urn:cts:latepig:inscriptions.doc17.hclat:2@maximae[1]	urn:cite:latepi:tokens.maximae
urn:cts:latepig:inscriptions.doc17.hclat:3@civilius[1]	urn:cite:latepi:tokens.civilius
urn:cts:latepig:inscriptions.doc17.hclat:3@creticus[1]	urn:cite:latepi:tokens.creticus
urn:cts:latepig:inscriptions.doc17.hclat:4@a[1]	urn:cite:latepi:tokens.a
urn:cts:latepig:inscriptions.doc17.hclat:4@sacris[1]	urn:cite:latepi:tokens.sacris
urn:cts:latepig:inscriptions.doc18.hclat:1@imp[1]	urn:cite:latepi:tokens.imp
urn:cts:latepig:inscriptions.doc18.hclat:1@imperatori[1]	urn:cite:latepi:tokens.imperatori
urn:cts:latepig:inscriptions.doc18.hclat:1@caes[1]	urn:cite:latepi:tokens.caes
urn:cts:latepig:inscriptions.doc18.hclat:1@caesari[1]	urn:cite:latepi:tokens.caesari
urn:cts:latepig:inscriptions.doc18.hclat:1@lucio[1]	urn:cite:latepi:tokens.lucio
urn:cts:latepig:inscriptions.doc18.hclat:1@septimio[1]	urn:cite:latepi:tokens.septimio
urn:cts:latepig:inscriptions.doc18.hclat:1@m[1]	urn:cite:latepi:tokens.m
urn:cts:latepig:inscriptions.doc18.hclat:1@marci[1]	urn:cite:latepi:tokens.marci
urn:cts:latepig:inscriptions.doc18.hclat:1@fil[1]	urn:cite:latepi:tokens.fil
urn:cts:latepig:inscriptions.doc18.hclat:1@filio[1]	urn:cite:latepi:tokens.filio
urn:cts:latepig:inscriptions.doc18.hclat:1@severo[1]	urn:cite:latepi:tokens.severo
urn:cts:latepig:inscriptions.doc18.hclat:1@pio[1]	urn:cite:latepi:tokens.pio
urn:cts:latepig:inscriptions.doc18.hclat:1@pertinaci[1]	urn:cite:latepi:tokens.pertinaci
urn:cts:latepig:inscriptions.doc18.hclat:1@aug[1]	urn:cite:latepi:tokens.aug
urn:cts:latepig:inscriptions.doc18.hclat:1@augusto[1]	urn:cite:latepi:tokens.augusto
urn:cts:latepig:inscriptions.doc18.hclat:1@patri[1]	urn:cite:latepi:tokens.patri
urn:cts:latepig:inscriptions.doc18.hclat:1@pa[1]	urn:cite:latepi:tokens.pa
urn:cts:latepig:inscriptions.doc18.hclat:1@tri[1]	urn:cite:latepi:tokens.tri
urn:cts:latepig:inscriptions.doc18.hclat:1@ae[1]	urn:cite:latepi:tokens.ae
urn:cts:latepig:inscriptions.doc18.hclat:1@parthico[1]	urn:cite:latepi:tokens.parthico
urn:cts:latepig:inscriptions.doc18.hclat:1@arabico[1]	urn:cite:latepi:tokens.arabico
urn:cts:latepig:inscriptions.doc18.hclat:1@et[1]	urn:cite:latepi:tokens.et
urn:cts:latepig:inscriptions.doc18.hclat:2@parthico[1]	urn:cite:latepi:tokens.parthico
urn:cts:latepig:inscriptions.doc18.hclat:2@adiabenico[1]	urn:cite:latepi:tokens.adiabenico
urn:cts:latepig:inscriptions.doc18.hclat:2@pontific[1]	urn:cite:latepi:tokens.pontific
urn:cts:latepig:inscriptions.doc18.hclat:2@pontifici[1]	urn:cite:latepi:tokens.pontifici
urn:cts:latepig:inscriptions.doc18.hclat:2@maximo[1]	urn:cite:latepi:tokens.maximo
urn:cts:latepig:inscriptions.doc18.hclat:2@tribunic[1]	urn:cite:latepi:tokens.tribunic
urn:cts:latepig:inscriptions.doc18.hclat:2@tribunicia[1]	urn:cite:latepi:tokens.tribunicia
urn:cts:latepig:inscriptions.doc18.hclat:2@potest[1]	urn:cite:latepi:tokens.potest
urn:cts:latepig:inscriptions.doc18.hclat:2@potestate[1]	urn:cite:latepi:tokens.potestate
urn:cts:latepig:inscriptions.doc18.hclat:2@xi[1]	urn:cite:latepi:tokens.xi
urn:cts:latepig:inscriptions.doc18.hclat:2@im[1]	urn:cite:latepi:tokens.im
urn:cts:latepig:inscriptions.doc18.hclat:2@p[1]	urn:cite:latepi:tokens.p
urn:cts:latepig:inscriptions.doc18.hclat:2@imperatori[1]	urn:cite:latepi:tokens.imperatori
urn:cts:latepig:inscriptions.doc18.hclat:2@xi[2]	urn:cite:latepi:tokens.xi
urn:cts:latepig:inscriptions.doc18.hclat:2@cos[1]	urn:cite:latepi:tokens.cos
urn:cts:latepig:inscriptions.doc18.hclat:2@consuli[1]	urn:cite:latepi:tokens.consuli
urn:cts:latepig:inscriptions.doc18.hclat:2@iii[1]	urn:cite:latepi:tokens.iii
urn:cts:latepig:inscriptions.doc18.hclat:2@procos[1]	urn:cite:latepi:tokens.procos
urn:cts:latepig:inscriptions.doc18.hclat:2@proconsuli[1]	urn:cite:latepi:tokens.proconsuli
urn:cts:latepig:inscriptions.doc18.hclat:2@et[1]	urn:cite:latepi:tokens.et
urn:cts:latepig:inscriptions.doc18.hclat:3@imp[1]	urn:cite:latepi:tokens.imp
urn:cts:latepig:inscriptions.doc18.hclat:3@imperatori[1]	urn:cite:latepi:tokens.imperatori
urn:cts:latepig:inscriptions.doc18.hclat:3@caes[1]	urn:cite:latepi:tokens.caes
urn:cts:latepig:inscriptions.doc18.hclat:3@caesari[1]	urn:cite:latepi:tokens.caesari
urn:cts:latepig:inscriptions.doc18.hclat:3@m[1]	urn:cite:latepi:tokens.m
urn:cts:latepig:inscriptions.doc18.hclat:3@marco[1]	urn:cite:latepi:tokens.marco
urn:cts:latepig:inscriptions.doc18.hclat:3@aurelio[1]	urn:cite:latepi:tokens.aurelio
urn:cts:latepig:inscriptions.doc18.hclat:3@l[1]	urn:cite:latepi:tokens.l
urn:cts:latepig:inscriptions.doc18.hclat:3@luci[1]	urn:cite:latepi:tokens.luci
urn:cts:latepig:inscriptions.doc18.hclat:3@fil[1]	urn:cite:latepi:tokens.fil
urn:cts:latepig:inscriptions.doc18.hclat:3@filio[1]	urn:cite:latepi:tokens.filio
urn:cts:latepig:inscriptions.doc18.hclat:3@antonino[1]	urn:cite:latepi:tokens.antonino
urn:cts:latepig:inscriptions.doc18.hclat:3@aug[1]	urn:cite:latepi:tokens.aug
urn:cts:latepig:inscriptions.doc18.hclat:3@augusto[1]	urn:cite:latepi:tokens.augusto
urn:cts:latepig:inscriptions.doc18.hclat:3@pio[1]	urn:cite:latepi:tokens.pio
urn:cts:latepig:inscriptions.doc18.hclat:3@felici[1]	urn:cite:latepi:tokens.felici
urn:cts:latepig:inscriptions.doc18.hclat:3@tribunic[1]	urn:cite:latepi:tokens.tribunic
urn:cts:latepig:inscriptions.doc18.hclat:3@tribunicia[1]	urn:cite:latepi:tokens.tribunicia
urn:cts:latepig:inscriptions.doc18.hclat:3@po[1]	urn:cite:latepi:tokens.po
urn:cts:latepig:inscriptions.doc18.hclat:3@test[1]	urn:cite:latepi:tokens.test
urn:cts:latepig:inscriptions.doc18.hclat:3@potestate[1]	urn:cite:latepi:tokens.potestate
urn:cts:latepig:inscriptions.doc18.hclat:3@vi[1]	urn:cite:latepi:tokens.vi
urn:cts:latepig:inscriptions.doc18.hclat:3@cos[1]	urn:cite:latepi:tokens.cos
urn:cts:latepig:inscriptions.doc18.hclat:3@consuli[1]	urn:cite:latepi:tokens.consuli
urn:cts:latepig:inscriptions.doc18.hclat:3@procos[1]	urn:cite:latepi:tokens.procos
urn:cts:latepig:inscriptions.doc18.hclat:3@proconsuli[1]	urn:cite:latepi:tokens.proconsuli
urn:cts:latepig:inscriptions.doc18.hclat:3@p[1]	urn:cite:latepi:tokens.p
urn:cts:latepig:inscriptions.doc18.hclat:3@p[2]	urn:cite:latepi:tokens.p
urn:cts:latepig:inscriptions.doc18.hclat:3@patri[1]	urn:cite:latepi:tokens.patri
urn:cts:latepig:inscriptions.doc18.hclat:3@patriae[1]	urn:cite:latepi:tokens.patriae
urn:cts:latepig:inscriptions.doc18.hclat:4@optimis[1]	urn:cite:latepi:tokens.optimis
urn:cts:latepig:inscriptions.doc18.hclat:4@fortissimisque[1]	urn:cite:latepi:tokens.fortissimisque
urn:cts:latepig:inscriptions.doc18.hclat:4@principibus[1]	urn:cite:latepi:tokens.principibus
urn:cts:latepig:inscriptions.doc18.hclat:5@ob[1]	urn:cite:latepi:tokens.ob
urn:cts:latepig:inscriptions.doc18.hclat:5@rem[1]	urn:cite:latepi:tokens.rem
urn:cts:latepig:inscriptions.doc18.hclat:5@publicam[1]	urn:cite:latepi:tokens.publicam
urn:cts:latepig:inscriptions.doc18.hclat:5@restitutam[1]	urn:cite:latepi:tokens.restitutam
urn:cts:latepig:inscriptions.doc18.hclat:5@imperiumque[1]	urn:cite:latepi:tokens.imperiumque
urn:cts:latepig:inscriptions.doc18.hclat:5@populi[1]	urn:cite:latepi:tokens.populi
urn:cts:latepig:inscriptions.doc18.hclat:5@romani[1]	urn:cite:latepi:tokens.romani
urn:cts:latepig:inscriptions.doc18.hclat:5@propagatum[1]	urn:cite:latepi:tokens.propagatum
urn:cts:latepig:inscriptions.doc18.hclat:6@insignibus[1]	urn:cite:latepi:tokens.insignibus
urn:cts:latepig:inscriptions.doc18.hclat:6@virtutibus[1]	urn:cite:latepi:tokens.virtutibus
urn:cts:latepig:inscriptions.doc18.hclat:6@eorum[1]	urn:cite:latepi:tokens.eorum
urn:cts:latepig:inscriptions.doc18.hclat:6@domi[1]	urn:cite:latepi:tokens.domi
urn:cts:latepig:inscriptions.doc18.hclat:6@forisque[1]	urn:cite:latepi:tokens.forisque
urn:cts:latepig:inscriptions.doc18.hclat:6@s[1]	urn:cite:latepi:tokens.s
urn:cts:latepig:inscriptions.doc18.hclat:6@senatus[1]	urn:cite:latepi:tokens.senatus
urn:cts:latepig:inscriptions.doc18.hclat:6@p[1]	urn:cite:latepi:tokens.p
urn:cts:latepig:inscriptions.doc18.hclat:6@populus[1]	urn:cite:latepi:tokens.populus
urn:cts:latepig:inscriptions.doc18.hclat:6@q[1]	urn:cite:latepi:tokens.q
urn:cts:latepig:inscriptions.doc18.hclat:6@que[1]	urn:cite:latepi:tokens.que
urn:cts:latepig:inscriptions.doc18.hclat:6@r[1]	urn:cite:latepi:tokens.r
urn:cts:latepig:inscriptions.doc18.hclat:6@romanus[1]	urn:cite:latepi:tokens.romanus
urn:cts:latepig:inscriptions.doc19.hclat:1@c[1]	urn:cite:latepi:tokens.c
urn:cts:latepig:inscriptions.doc19.hclat:1@gaius[1]	urn:cite:latepi:tokens.gaius
urn:cts:latepig:inscriptions.doc19.hclat:1@caprius[1]	urn:cite:latepi:tokens.caprius
urn:cts:latepig:inscriptions.doc19.hclat:1@c[2]	urn:cite:latepi:tokens.c
urn:cts:latepig:inscriptions.doc19.hclat:1@gaii[1]	urn:cite:latepi:tokens.gaii
urn:cts:latepig:inscriptions.doc19.hclat:1@f[1]	urn:cite:latepi:tokens.f
urn:cts:latepig:inscriptions.doc19.hclat:1@filius[1]	urn:cite:latepi:tokens.filius
urn:cts:latepig:inscriptions.doc19.hclat:1@ter[1]	urn:cite:latepi:tokens.ter
urn:cts:latepig:inscriptions.doc19.hclat:1@tertius[1]	urn:cite:latepi:tokens.tertius
urn:cts:latepig:inscriptions.doc19.hclat:1@c[3]	urn:cite:latepi:tokens.c
urn:cts:latepig:inscriptions.doc19.hclat:1@clarissimus[1]	urn:cite:latepi:tokens.clarissimus
urn:cts:latepig:inscriptions.doc19.hclat:1@n[1]	urn:cite:latepi:tokens.n
urn:cts:latepig:inscriptions.doc19.hclat:2@iiii[1]	urn:cite:latepi:tokens.iiii
urn:cts:latepig:inscriptions.doc19.hclat:2@virid[1]	urn:cite:latepi:tokens.virid
urn:cts:latepig:inscriptions.doc19.hclat:2@iterumq[1]	urn:cite:latepi:tokens.iterumq
urn:cts:latepig:inscriptions.doc19.hclat:2@iterumque[1]	urn:cite:latepi:tokens.iterumque
urn:cts:latepig:inscriptions.doc19.hclat:3@pontifex[1]	urn:cite:latepi:tokens.pontifex
urn:cts:latepig:inscriptions.doc19.hclat:3@tr[1]	urn:cite:latepi:tokens.tr
urn:cts:latepig:inscriptions.doc19.hclat:3@tribunus[1]	urn:cite:latepi:tokens.tribunus
urn:cts:latepig:inscriptions.doc19.hclat:3@mil[1]	urn:cite:latepi:tokens.mil
urn:cts:latepig:inscriptions.doc19.hclat:3@militum[1]	urn:cite:latepi:tokens.militum
urn:cts:latepig:inscriptions.doc19.hclat:4@cerrinia[1]	urn:cite:latepi:tokens.cerrinia
urn:cts:latepig:inscriptions.doc19.hclat:4@l[1]	urn:cite:latepi:tokens.l
urn:cts:latepig:inscriptions.doc19.hclat:4@luci[1]	urn:cite:latepi:tokens.luci
urn:cts:latepig:inscriptions.doc19.hclat:4@f[1]	urn:cite:latepi:tokens.f
urn:cts:latepig:inscriptions.doc19.hclat:4@filia[1]	urn:cite:latepi:tokens.filia
urn:cts:latepig:inscriptions.doc19.hclat:4@uxor[1]	urn:cite:latepi:tokens.uxor
urn:cts:latepig:inscriptions.doc2.hclat:1@imp[1]	urn:cite:latepi:tokens.imp
urn:cts:latepig:inscriptions.doc2.hclat:1@imperator[1]	urn:cite:latepi:tokens.imperator
urn:cts:latepig:inscriptions.doc2.hclat:1@c[1]	urn:cite:latepi:tokens.c
urn:cts:latepig:inscriptions.doc2.hclat:1@aes[1]	urn:cite:latepi:tokens.aes
urn:cts:latepig:inscriptions.doc2.hclat:1@ar[1]	urn:cite:latepi:tokens.ar
urn:cts:latepig:inscriptions.doc2.hclat:1@d[1]	urn:cite:latepi:tokens.d
urn:cts:latepig:inscriptions.doc2.hclat:1@ivi[1]	urn:cite:latepi:tokens.ivi
urn:cts:latepig:inscriptions.doc2.hclat:1@vesp[1]	urn:cite:latepi:tokens.vesp
urn:cts:latepig:inscriptions.doc2.hclat:1@asiani[1]	urn:cite:latepi:tokens.asiani
urn:cts:latepig:inscriptions.doc2.hclat:1@f[1]	urn:cite:latepi:tokens.f
urn:cts:latepig:inscriptions.doc2.hclat:1@filius[1]	urn:cite:latepi:tokens.filius
urn:cts:latepig:inscriptions.doc2.hclat:1@d[2]	urn:cite:latepi:tokens.d
urn:cts:latepig:inscriptions.doc2.hclat:1@omitian[1]	urn:cite:latepi:tokens.omitian
urn:cts:latepig:inscriptions.doc2.hclat:1@us[1]	urn:cite:latepi:tokens.us
urn:cts:latepig:inscriptions.doc2.hclat:2@aug[1]	urn:cite:latepi:tokens.aug
urn:cts:latepig:inscriptions.doc2.hclat:2@augustus[1]	urn:cite:latepi:tokens.augustus
urn:cts:latepig:inscriptions.doc2.hclat:2@germa[1]	urn:cite:latepi:tokens.germa
urn:cts:latepig:inscriptions.doc2.hclat:2@nic[1]	urn:cite:latepi:tokens.nic
urn:cts:latepig:inscriptions.doc2.hclat:2@us[1]	urn:cite:latepi:tokens.us
urn:cts:latepig:inscriptions.doc2.hclat:2@pont[1]	urn:cite:latepi:tokens.pont
urn:cts:latepig:inscriptions.doc2.hclat:2@pontifex[1]	urn:cite:latepi:tokens.pontifex
urn:cts:latepig:inscriptions.doc2.hclat:2@maxim[1]	urn:cite:latepi:tokens.maxim
urn:cts:latepig:inscriptions.doc2.hclat:2@maximus[1]	urn:cite:latepi:tokens.maximus
urn:cts:latepig:inscriptions.doc2.hclat:2@tr[1]	urn:cite:latepi:tokens.tr
urn:cts:latepig:inscriptions.doc2.hclat:2@ib[1]	urn:cite:latepi:tokens.ib
urn:cts:latepig:inscriptions.doc2.hclat:2@tribunicia[1]	urn:cite:latepi:tokens.tribunicia
urn:cts:latepig:inscriptions.doc2.hclat:2@pot[1]	urn:cite:latepi:tokens.pot
urn:cts:latepig:inscriptions.doc2.hclat:2@est[1]	urn:cite:latepi:tokens.est
urn:cts:latepig:inscriptions.doc2.hclat:2@potestate[1]	urn:cite:latepi:tokens.potestate
urn:cts:latepig:inscriptions.doc2.hclat:2@iii[1]	urn:cite:latepi:tokens.iii
urn:cts:latepig:inscriptions.doc2.hclat:2@p[1]	urn:cite:latepi:tokens.p
urn:cts:latepig:inscriptions.doc2.hclat:2@p[2]	urn:cite:latepi:tokens.p
urn:cts:latepig:inscriptions.doc2.hclat:2@pater[1]	urn:cite:latepi:tokens.pater
urn:cts:latepig:inscriptions.doc2.hclat:2@patriae[1]	urn:cite:latepi:tokens.patriae
urn:cts:latepig:inscriptions.doc2.hclat:2@imp[1]	urn:cite:latepi:tokens.imp
urn:cts:latepig:inscriptions.doc2.hclat:2@imperator[1]	urn:cite:latepi:tokens.imperator
urn:cts:latepig:inscriptions.doc2.hclat:2@vii[1]	urn:cite:latepi:tokens.vii
urn:cts:latepig:inscriptions.doc2.hclat:2@cos[1]	urn:cite:latepi:tokens.cos
urn:cts:latepig:inscriptions.doc2.hclat:2@consul[1]	urn:cite:latepi:tokens.consul
urn:cts:latepig:inscriptions.doc2.hclat:2@x[1]	urn:cite:latepi:tokens.x
urn:cts:latepig:inscriptions.doc2.hclat:2@des[1]	urn:cite:latepi:tokens.des
urn:cts:latepig:inscriptions.doc2.hclat:2@designatus[1]	urn:cite:latepi:tokens.designatus
urn:cts:latepig:inscriptions.doc2.hclat:2@xi[1]	urn:cite:latepi:tokens.xi
urn:cts:latepig:inscriptions.doc2.hclat:3@templu[1]	urn:cite:latepi:tokens.templu
urn:cts:latepig:inscriptions.doc2.hclat:3@m[1]	urn:cite:latepi:tokens.m
urn:cts:latepig:inscriptions.doc2.hclat:3@ap[1]	urn:cite:latepi:tokens.ap
urn:cts:latepig:inscriptions.doc2.hclat:3@ollinis[1]	urn:cite:latepi:tokens.ollinis
urn:cts:latepig:inscriptions.doc2.hclat:3@sua[1]	urn:cite:latepi:tokens.sua
urn:cts:latepig:inscriptions.doc2.hclat:3@i[1]	urn:cite:latepi:tokens.i
urn:cts:latepig:inscriptions.doc2.hclat:3@npensa[1]	urn:cite:latepi:tokens.npensa
urn:cts:latepig:inscriptions.doc2.hclat:3@refecit[1]	urn:cite:latepi:tokens.refecit
urn:cts:latepig:inscriptions.doc20.hclat:1@corelliae[1]	urn:cite:latepi:tokens.corelliae
urn:cts:latepig:inscriptions.doc20.hclat:1@c[1]	urn:cite:latepi:tokens.c
urn:cts:latepig:inscriptions.doc20.hclat:1@gaii[1]	urn:cite:latepi:tokens.gaii
urn:cts:latepig:inscriptions.doc20.hclat:1@f[1]	urn:cite:latepi:tokens.f
urn:cts:latepig:inscriptions.doc20.hclat:1@filiae[1]	urn:cite:latepi:tokens.filiae
urn:cts:latepig:inscriptions.doc20.hclat:1@gallae[1]	urn:cite:latepi:tokens.gallae
urn:cts:latepig:inscriptions.doc20.hclat:1@papianae[1]	urn:cite:latepi:tokens.papianae
urn:cts:latepig:inscriptions.doc20.hclat:2@uxori[1]	urn:cite:latepi:tokens.uxori
urn:cts:latepig:inscriptions.doc20.hclat:2@c[1]	urn:cite:latepi:tokens.c
urn:cts:latepig:inscriptions.doc20.hclat:2@gaii[1]	urn:cite:latepi:tokens.gaii
urn:cts:latepig:inscriptions.doc20.hclat:2@corelli[1]	urn:cite:latepi:tokens.corelli
urn:cts:latepig:inscriptions.doc20.hclat:2@n[1]	urn:cite:latepi:tokens.n
urn:cts:latepig:inscriptions.doc20.hclat:2@f[1]	urn:cite:latepi:tokens.f
urn:cts:latepig:inscriptions.doc20.hclat:2@filio[1]	urn:cite:latepi:tokens.filio
urn:cts:latepig:inscriptions.doc20.hclat:2@fab[1]	urn:cite:latepi:tokens.fab
urn:cts:latepig:inscriptions.doc20.hclat:3@quae[1]	urn:cite:latepi:tokens.quae
urn:cts:latepig:inscriptions.doc20.hclat:3@testamento[1]	urn:cite:latepi:tokens.testamento
urn:cts:latepig:inscriptions.doc20.hclat:3@dedit[1]	urn:cite:latepi:tokens.dedit
urn:cts:latepig:inscriptions.doc20.hclat:3@coloniae[1]	urn:cite:latepi:tokens.coloniae
urn:cts:latepig:inscriptions.doc20.hclat:4@menturnensi[1]	urn:cite:latepi:tokens.menturnensi
urn:cts:latepig:inscriptions.doc20.hclat:4@iis[1]	urn:cite:latepi:tokens.iis
urn:cts:latepig:inscriptions.doc20.hclat:4@c[1]	urn:cite:latepi:tokens.c
urn:cts:latepig:inscriptions.doc20.hclat:4@et[1]	urn:cite:latepi:tokens.et
urn:cts:latepig:inscriptions.doc20.hclat:4@municipio[1]	urn:cite:latepi:tokens.municipio
urn:cts:latepig:inscriptions.doc20.hclat:4@casini[1]	urn:cite:latepi:tokens.casini
urn:cts:latepig:inscriptions.doc20.hclat:4@iis[2]	urn:cite:latepi:tokens.iis
urn:cts:latepig:inscriptions.doc20.hclat:4@c[2]	urn:cite:latepi:tokens.c
urn:cts:latepig:inscriptions.doc20.hclat:5@ita[1]	urn:cite:latepi:tokens.ita
urn:cts:latepig:inscriptions.doc20.hclat:5@uti[1]	urn:cite:latepi:tokens.uti
urn:cts:latepig:inscriptions.doc20.hclat:5@vii[1]	urn:cite:latepi:tokens.vii
urn:cts:latepig:inscriptions.doc20.hclat:5@idus[1]	urn:cite:latepi:tokens.idus
urn:cts:latepig:inscriptions.doc20.hclat:5@mart[1]	urn:cite:latepi:tokens.mart
urn:cts:latepig:inscriptions.doc20.hclat:5@martias[1]	urn:cite:latepi:tokens.martias
urn:cts:latepig:inscriptions.doc20.hclat:5@natali[1]	urn:cite:latepi:tokens.natali
urn:cts:latepig:inscriptions.doc20.hclat:5@suo[1]	urn:cite:latepi:tokens.suo
urn:cts:latepig:inscriptions.doc20.hclat:6@quod[1]	urn:cite:latepi:tokens.quod
urn:cts:latepig:inscriptions.doc20.hclat:6@annis[1]	urn:cite:latepi:tokens.annis
urn:cts:latepig:inscriptions.doc20.hclat:6@crustulum[1]	urn:cite:latepi:tokens.crustulum
urn:cts:latepig:inscriptions.doc20.hclat:6@et[1]	urn:cite:latepi:tokens.et
urn:cts:latepig:inscriptions.doc20.hclat:6@mulsum[1]	urn:cite:latepi:tokens.mulsum
urn:cts:latepig:inscriptions.doc20.hclat:6@detur[1]	urn:cite:latepi:tokens.detur
urn:cts:latepig:inscriptions.doc20.hclat:7@ex[1]	urn:cite:latepi:tokens.ex
urn:cts:latepig:inscriptions.doc20.hclat:7@testamento[1]	urn:cite:latepi:tokens.testamento
urn:cts:latepig:inscriptions.doc20.hclat:7@fieri[1]	urn:cite:latepi:tokens.fieri
urn:cts:latepig:inscriptions.doc20.hclat:7@iussit[1]	urn:cite:latepi:tokens.iussit
urn:cts:latepig:inscriptions.doc20.hclat:7@iis[1]	urn:cite:latepi:tokens.iis
urn:cts:latepig:inscriptions.doc20.hclat:7@c[1]	urn:cite:latepi:tokens.c
urn:cts:latepig:inscriptions.doc21.hclat:1@aedivi[1]	urn:cite:latepi:tokens.aedivi
urn:cts:latepig:inscriptions.doc21.hclat:1@claudi[1]	urn:cite:latepi:tokens.claudi
urn:cts:latepig:inscriptions.doc21.hclat:1@b[1]	urn:cite:latepi:tokens.b
urn:cts:latepig:inscriptions.doc21.hclat:2@cus[1]	urn:cite:latepi:tokens.cus
urn:cts:latepig:inscriptions.doc21.hclat:2@accensi[1]	urn:cite:latepi:tokens.accensi
urn:cts:latepig:inscriptions.doc21.hclat:2@divi[1]	urn:cite:latepi:tokens.divi
urn:cts:latepig:inscriptions.doc21.hclat:2@claudi[1]	urn:cite:latepi:tokens.claudi
urn:cts:latepig:inscriptions.doc21.hclat:3@au[1]	urn:cite:latepi:tokens.au
urn:cts:latepig:inscriptions.doc21.hclat:3@gustales[1]	urn:cite:latepi:tokens.gustales
urn:cts:latepig:inscriptions.doc22.hclat:1@m[1]	urn:cite:latepi:tokens.m
urn:cts:latepig:inscriptions.doc22.hclat:1@marcus[1]	urn:cite:latepi:tokens.marcus
urn:cts:latepig:inscriptions.doc22.hclat:1@obultronius[1]	urn:cite:latepi:tokens.obultronius
urn:cts:latepig:inscriptions.doc22.hclat:1@cultellus[1]	urn:cite:latepi:tokens.cultellus
urn:cts:latepig:inscriptions.doc22.hclat:1@praef[1]	urn:cite:latepi:tokens.praef
urn:cts:latepig:inscriptions.doc22.hclat:1@praefectus[1]	urn:cite:latepi:tokens.praefectus
urn:cts:latepig:inscriptions.doc22.hclat:1@fabr[1]	urn:cite:latepi:tokens.fabr
urn:cts:latepig:inscriptions.doc22.hclat:1@fabrum[1]	urn:cite:latepi:tokens.fabrum
urn:cts:latepig:inscriptions.doc22.hclat:2@divi[1]	urn:cite:latepi:tokens.divi
urn:cts:latepig:inscriptions.doc22.hclat:2@claudi[1]	urn:cite:latepi:tokens.claudi
urn:cts:latepig:inscriptions.doc22.hclat:2@iussu[1]	urn:cite:latepi:tokens.iussu
urn:cts:latepig:inscriptions.doc22.hclat:2@caesaris[1]	urn:cite:latepi:tokens.caesaris
urn:cts:latepig:inscriptions.doc22.hclat:2@dedicavit[1]	urn:cite:latepi:tokens.dedicavit
urn:cts:latepig:inscriptions.doc23.hclat:1@c[1]	urn:cite:latepi:tokens.c
urn:cts:latepig:inscriptions.doc23.hclat:1@gaio[1]	urn:cite:latepi:tokens.gaio
urn:cts:latepig:inscriptions.doc23.hclat:1@octavio[1]	urn:cite:latepi:tokens.octavio
urn:cts:latepig:inscriptions.doc23.hclat:1@app[1]	urn:cite:latepi:tokens.app
urn:cts:latepig:inscriptions.doc23.hclat:1@appio[1]	urn:cite:latepi:tokens.appio
urn:cts:latepig:inscriptions.doc23.hclat:1@suetrio[1]	urn:cite:latepi:tokens.suetrio
urn:cts:latepig:inscriptions.doc23.hclat:1@sabino[1]	urn:cite:latepi:tokens.sabino
urn:cts:latepig:inscriptions.doc23.hclat:1@c[2]	urn:cite:latepi:tokens.c
urn:cts:latepig:inscriptions.doc23.hclat:1@v[1]	urn:cite:latepi:tokens.v
urn:cts:latepig:inscriptions.doc23.hclat:1@clarissimo[1]	urn:cite:latepi:tokens.clarissimo
urn:cts:latepig:inscriptions.doc23.hclat:1@viro[1]	urn:cite:latepi:tokens.viro
urn:cts:latepig:inscriptions.doc23.hclat:1@cos[1]	urn:cite:latepi:tokens.cos
urn:cts:latepig:inscriptions.doc23.hclat:1@consuli[1]	urn:cite:latepi:tokens.consuli
urn:cts:latepig:inscriptions.doc23.hclat:1@ordinario[1]	urn:cite:latepi:tokens.ordinario
urn:cts:latepig:inscriptions.doc23.hclat:1@pontifici[1]	urn:cite:latepi:tokens.pontifici
urn:cts:latepig:inscriptions.doc23.hclat:2@auguri[1]	urn:cite:latepi:tokens.auguri
urn:cts:latepig:inscriptions.doc23.hclat:2@comitia[1]	urn:cite:latepi:tokens.comitia
urn:cts:latepig:inscriptions.doc23.hclat:2@aug[1]	urn:cite:latepi:tokens.aug
urn:cts:latepig:inscriptions.doc23.hclat:2@augusti[1]	urn:cite:latepi:tokens.augusti
urn:cts:latepig:inscriptions.doc23.hclat:2@n[1]	urn:cite:latepi:tokens.n
urn:cts:latepig:inscriptions.doc23.hclat:2@nepoti[1]	urn:cite:latepi:tokens.nepoti
urn:cts:latepig:inscriptions.doc23.hclat:2@electo[1]	urn:cite:latepi:tokens.electo
urn:cts:latepig:inscriptions.doc23.hclat:2@ad[1]	urn:cite:latepi:tokens.ad
urn:cts:latepig:inscriptions.doc23.hclat:2@corrigendum[1]	urn:cite:latepi:tokens.corrigendum
urn:cts:latepig:inscriptions.doc23.hclat:2@statum[1]	urn:cite:latepi:tokens.statum
urn:cts:latepig:inscriptions.doc23.hclat:2@italiae[1]	urn:cite:latepi:tokens.italiae
urn:cts:latepig:inscriptions.doc23.hclat:3@alimentorum[1]	urn:cite:latepi:tokens.alimentorum
urn:cts:latepig:inscriptions.doc23.hclat:3@iudici[1]	urn:cite:latepi:tokens.iudici
urn:cts:latepig:inscriptions.doc23.hclat:3@ex[1]	urn:cite:latepi:tokens.ex
urn:cts:latepig:inscriptions.doc23.hclat:3@delegatu[1]	urn:cite:latepi:tokens.delegatu
urn:cts:latepig:inscriptions.doc23.hclat:3@principum[1]	urn:cite:latepi:tokens.principum
urn:cts:latepig:inscriptions.doc23.hclat:3@in[1]	urn:cite:latepi:tokens.in
urn:cts:latepig:inscriptions.doc23.hclat:3@provincia[1]	urn:cite:latepi:tokens.provincia
urn:cts:latepig:inscriptions.doc23.hclat:4@dalmatia[1]	urn:cite:latepi:tokens.dalmatia
urn:cts:latepig:inscriptions.doc23.hclat:4@item[1]	urn:cite:latepi:tokens.item
urn:cts:latepig:inscriptions.doc23.hclat:4@pannonia[1]	urn:cite:latepi:tokens.pannonia
urn:cts:latepig:inscriptions.doc23.hclat:4@inferiore[1]	urn:cite:latepi:tokens.inferiore
urn:cts:latepig:inscriptions.doc23.hclat:4@leg[1]	urn:cite:latepi:tokens.leg
urn:cts:latepig:inscriptions.doc23.hclat:4@legato[1]	urn:cite:latepi:tokens.legato
urn:cts:latepig:inscriptions.doc23.hclat:4@aug[1]	urn:cite:latepi:tokens.aug
urn:cts:latepig:inscriptions.doc23.hclat:4@augusto[1]	urn:cite:latepi:tokens.augusto
urn:cts:latepig:inscriptions.doc23.hclat:4@pr[1]	urn:cite:latepi:tokens.pr
urn:cts:latepig:inscriptions.doc23.hclat:4@pr[2]	urn:cite:latepi:tokens.pr
urn:cts:latepig:inscriptions.doc23.hclat:4@praefecto[1]	urn:cite:latepi:tokens.praefecto
urn:cts:latepig:inscriptions.doc23.hclat:4@praetorio[1]	urn:cite:latepi:tokens.praetorio
urn:cts:latepig:inscriptions.doc23.hclat:4@provinciae[1]	urn:cite:latepi:tokens.provinciae
urn:cts:latepig:inscriptions.doc23.hclat:5@praeposito[1]	urn:cite:latepi:tokens.praeposito
urn:cts:latepig:inscriptions.doc23.hclat:5@vexillaris[1]	urn:cite:latepi:tokens.vexillaris
urn:cts:latepig:inscriptions.doc23.hclat:5@germanicae[1]	urn:cite:latepi:tokens.germanicae
urn:cts:latepig:inscriptions.doc23.hclat:5@expeditionis[1]	urn:cite:latepi:tokens.expeditionis
urn:cts:latepig:inscriptions.doc23.hclat:5@legato[1]	urn:cite:latepi:tokens.legato
urn:cts:latepig:inscriptions.doc23.hclat:6@leg[1]	urn:cite:latepi:tokens.leg
urn:cts:latepig:inscriptions.doc23.hclat:6@legatus[1]	urn:cite:latepi:tokens.legatus
urn:cts:latepig:inscriptions.doc23.hclat:6@xxii[1]	urn:cite:latepi:tokens.xxii
urn:cts:latepig:inscriptions.doc23.hclat:6@primigeniae[1]	urn:cite:latepi:tokens.primigeniae
urn:cts:latepig:inscriptions.doc23.hclat:6@piae[1]	urn:cite:latepi:tokens.piae
urn:cts:latepig:inscriptions.doc23.hclat:6@fidelis[1]	urn:cite:latepi:tokens.fidelis
urn:cts:latepig:inscriptions.doc23.hclat:6@iuridicoperae[1]	urn:cite:latepi:tokens.iuridicoperae
urn:cts:latepig:inscriptions.doc23.hclat:6@miliam[1]	urn:cite:latepi:tokens.miliam
urn:cts:latepig:inscriptions.doc23.hclat:6@et[1]	urn:cite:latepi:tokens.et
urn:cts:latepig:inscriptions.doc23.hclat:6@liguriam[1]	urn:cite:latepi:tokens.liguriam
urn:cts:latepig:inscriptions.doc23.hclat:6@curator[1]	urn:cite:latepi:tokens.curator
urn:cts:latepig:inscriptions.doc23.hclat:7@viae[1]	urn:cite:latepi:tokens.viae
urn:cts:latepig:inscriptions.doc23.hclat:7@latinae[1]	urn:cite:latepi:tokens.latinae
urn:cts:latepig:inscriptions.doc23.hclat:7@legato[1]	urn:cite:latepi:tokens.legato
urn:cts:latepig:inscriptions.doc23.hclat:7@prov[1]	urn:cite:latepi:tokens.prov
urn:cts:latepig:inscriptions.doc23.hclat:7@provinciae[1]	urn:cite:latepi:tokens.provinciae
urn:cts:latepig:inscriptions.doc23.hclat:7@africae[1]	urn:cite:latepi:tokens.africae
urn:cts:latepig:inscriptions.doc23.hclat:7@regionis[1]	urn:cite:latepi:tokens.regionis
urn:cts:latepig:inscriptions.doc23.hclat:7@hipponiensis[1]	urn:cite:latepi:tokens.hipponiensis
urn:cts:latepig:inscriptions.doc23.hclat:7@praetori[1]	urn:cite:latepi:tokens.praetori
urn:cts:latepig:inscriptions.doc23.hclat:8@trib[1]	urn:cite:latepi:tokens.trib
urn:cts:latepig:inscriptions.doc23.hclat:8@tribunus[1]	urn:cite:latepi:tokens.tribunus
urn:cts:latepig:inscriptions.doc23.hclat:8@bl[1]	urn:cite:latepi:tokens.bl
urn:cts:latepig:inscriptions.doc23.hclat:8@cand[1]	urn:cite:latepi:tokens.cand
urn:cts:latepig:inscriptions.doc23.hclat:8@o[1]	urn:cite:latepi:tokens.o
urn:cts:latepig:inscriptions.doc23.hclat:8@optimus[1]	urn:cite:latepi:tokens.optimus
urn:cts:latepig:inscriptions.doc23.hclat:8@cand[2]	urn:cite:latepi:tokens.cand
urn:cts:latepig:inscriptions.doc23.hclat:8@servirotur[1]	urn:cite:latepi:tokens.servirotur
urn:cts:latepig:inscriptions.doc23.hclat:8@marum[1]	urn:cite:latepi:tokens.marum
urn:cts:latepig:inscriptions.doc23.hclat:8@equestrium[1]	urn:cite:latepi:tokens.equestrium
urn:cts:latepig:inscriptions.doc23.hclat:9@patrono[1]	urn:cite:latepi:tokens.patrono
urn:cts:latepig:inscriptions.doc23.hclat:9@amantissimo[1]	urn:cite:latepi:tokens.amantissimo
urn:cts:latepig:inscriptions.doc24.hclat:1@imp[1]	urn:cite:latepi:tokens.imp
urn:cts:latepig:inscriptions.doc24.hclat:1@imperatori[1]	urn:cite:latepi:tokens.imperatori
urn:cts:latepig:inscriptions.doc24.hclat:1@caesari[1]	urn:cite:latepi:tokens.caesari
urn:cts:latepig:inscriptions.doc24.hclat:1@divi[1]	urn:cite:latepi:tokens.divi
urn:cts:latepig:inscriptions.doc24.hclat:1@f[1]	urn:cite:latepi:tokens.f
urn:cts:latepig:inscriptions.doc24.hclat:1@filio[1]	urn:cite:latepi:tokens.filio
urn:cts:latepig:inscriptions.doc24.hclat:2@augusto[1]	urn:cite:latepi:tokens.augusto
urn:cts:latepig:inscriptions.doc24.hclat:3@cos[1]	urn:cite:latepi:tokens.cos
urn:cts:latepig:inscriptions.doc24.hclat:3@consul[1]	urn:cite:latepi:tokens.consul
urn:cts:latepig:inscriptions.doc24.hclat:3@xi[1]	urn:cite:latepi:tokens.xi
urn:cts:latepig:inscriptions.doc24.hclat:3@imp[1]	urn:cite:latepi:tokens.imp
urn:cts:latepig:inscriptions.doc24.hclat:3@imperator[1]	urn:cite:latepi:tokens.imperator
urn:cts:latepig:inscriptions.doc24.hclat:3@vii[1]	urn:cite:latepi:tokens.vii
urn:cts:latepig:inscriptions.doc24.hclat:4@tribunic[1]	urn:cite:latepi:tokens.tribunic
urn:cts:latepig:inscriptions.doc24.hclat:4@tribunicia[1]	urn:cite:latepi:tokens.tribunicia
urn:cts:latepig:inscriptions.doc24.hclat:4@potest[1]	urn:cite:latepi:tokens.potest
urn:cts:latepig:inscriptions.doc24.hclat:4@potestate[1]	urn:cite:latepi:tokens.potestate
urn:cts:latepig:inscriptions.doc24.hclat:5@prubrius[1]	urn:cite:latepi:tokens.prubrius
urn:cts:latepig:inscriptions.doc24.hclat:5@m[1]	urn:cite:latepi:tokens.m
urn:cts:latepig:inscriptions.doc24.hclat:5@marci[1]	urn:cite:latepi:tokens.marci
urn:cts:latepig:inscriptions.doc24.hclat:5@f[1]	urn:cite:latepi:tokens.f
urn:cts:latepig:inscriptions.doc24.hclat:5@filius[1]	urn:cite:latepi:tokens.filius
urn:cts:latepig:inscriptions.doc24.hclat:5@maebarba[1]	urn:cite:latepi:tokens.maebarba
urn:cts:latepig:inscriptions.doc25.hclat:1@imp[1]	urn:cite:latepi:tokens.imp
urn:cts:latepig:inscriptions.doc25.hclat:1@imperatori[1]	urn:cite:latepi:tokens.imperatori
urn:cts:latepig:inscriptions.doc25.hclat:1@caesari[1]	urn:cite:latepi:tokens.caesari
urn:cts:latepig:inscriptions.doc25.hclat:2@limiose[1]	urn:cite:latepi:tokens.limiose
urn:cts:latepig:inscriptions.doc25.hclat:3@vero[1]	urn:cite:latepi:tokens.vero
urn:cts:latepig:inscriptions.doc25.hclat:3@pio[1]	urn:cite:latepi:tokens.pio
urn:cts:latepig:inscriptions.doc25.hclat:3@per[1]	urn:cite:latepi:tokens.per
urn:cts:latepig:inscriptions.doc25.hclat:4@tinaci[1]	urn:cite:latepi:tokens.tinaci
urn:cts:latepig:inscriptions.doc25.hclat:4@aug[1]	urn:cite:latepi:tokens.aug
urn:cts:latepig:inscriptions.doc25.hclat:4@augusto[1]	urn:cite:latepi:tokens.augusto
urn:cts:latepig:inscriptions.doc25.hclat:7@viiii[1]	urn:cite:latepi:tokens.viiii
urn:cts:latepig:inscriptions.doc25.hclat:8@xi[1]	urn:cite:latepi:tokens.xi
urn:cts:latepig:inscriptions.doc25.hclat:8@cos[1]	urn:cite:latepi:tokens.cos
urn:cts:latepig:inscriptions.doc25.hclat:8@consul[1]	urn:cite:latepi:tokens.consul
urn:cts:latepig:inscriptions.doc25.hclat:9@collegium[1]	urn:cite:latepi:tokens.collegium
urn:cts:latepig:inscriptions.doc25.hclat:10@alneaior[1]	urn:cite:latepi:tokens.alneaior
urn:cts:latepig:inscriptions.doc26.hclat:1@castra[1]	urn:cite:latepi:tokens.castra
urn:cts:latepig:inscriptions.doc26.hclat:1@dei[1]	urn:cite:latepi:tokens.dei
urn:cts:latepig:inscriptions.doc26.hclat:1@sunt[1]	urn:cite:latepi:tokens.sunt
urn:cts:latepig:inscriptions.doc26.hclat:1@haec[1]	urn:cite:latepi:tokens.haec
urn:cts:latepig:inscriptions.doc27.hclat:1@virgo[1]	urn:cite:latepi:tokens.virgo
urn:cts:latepig:inscriptions.doc27.hclat:2@dei[1]	urn:cite:latepi:tokens.dei
urn:cts:latepig:inscriptions.doc27.hclat:2@genitrix[1]	urn:cite:latepi:tokens.genitrix
urn:cts:latepig:inscriptions.doc27.hclat:3@intercede[1]	urn:cite:latepi:tokens.intercede
urn:cts:latepig:inscriptions.doc27.hclat:4@pro[1]	urn:cite:latepi:tokens.pro
urn:cts:latepig:inscriptions.doc27.hclat:4@nobis[1]	urn:cite:latepi:tokens.nobis
urn:cts:latepig:inscriptions.doc28.hclat:1@haec[1]	urn:cite:latepi:tokens.haec
urn:cts:latepig:inscriptions.doc28.hclat:1@domus[1]	urn:cite:latepi:tokens.domus
urn:cts:latepig:inscriptions.doc28.hclat:1@dei[1]	urn:cite:latepi:tokens.dei
urn:cts:latepig:inscriptions.doc29.hclat:1@l[1]	urn:cite:latepi:tokens.l
urn:cts:latepig:inscriptions.doc29.hclat:1@lucius[1]	urn:cite:latepi:tokens.lucius
urn:cts:latepig:inscriptions.doc29.hclat:1@fabricius[1]	urn:cite:latepi:tokens.fabricius
urn:cts:latepig:inscriptions.doc29.hclat:1@c[1]	urn:cite:latepi:tokens.c
urn:cts:latepig:inscriptions.doc29.hclat:1@gaii[1]	urn:cite:latepi:tokens.gaii
urn:cts:latepig:inscriptions.doc29.hclat:1@f[1]	urn:cite:latepi:tokens.f
urn:cts:latepig:inscriptions.doc29.hclat:1@filius[1]	urn:cite:latepi:tokens.filius
urn:cts:latepig:inscriptions.doc29.hclat:1@cur[1]	urn:cite:latepi:tokens.cur
urn:cts:latepig:inscriptions.doc29.hclat:1@curator[1]	urn:cite:latepi:tokens.curator
urn:cts:latepig:inscriptions.doc29.hclat:1@viar[1]	urn:cite:latepi:tokens.viar
urn:cts:latepig:inscriptions.doc29.hclat:1@viarum[1]	urn:cite:latepi:tokens.viarum
urn:cts:latepig:inscriptions.doc29.hclat:2@faciundum[1]	urn:cite:latepi:tokens.faciundum
urn:cts:latepig:inscriptions.doc29.hclat:2@coepavit[1]	urn:cite:latepi:tokens.coepavit
urn:cts:latepig:inscriptions.doc3.hclat:1@l[1]	urn:cite:latepi:tokens.l
urn:cts:latepig:inscriptions.doc3.hclat:1@lucius[1]	urn:cite:latepi:tokens.lucius
urn:cts:latepig:inscriptions.doc3.hclat:1@aemilius[1]	urn:cite:latepi:tokens.aemilius
urn:cts:latepig:inscriptions.doc3.hclat:1@l[2]	urn:cite:latepi:tokens.l
urn:cts:latepig:inscriptions.doc3.hclat:1@lucii[1]	urn:cite:latepi:tokens.lucii
urn:cts:latepig:inscriptions.doc3.hclat:1@f[1]	urn:cite:latepi:tokens.f
urn:cts:latepig:inscriptions.doc3.hclat:1@filius[1]	urn:cite:latepi:tokens.filius
urn:cts:latepig:inscriptions.doc3.hclat:1@inperator[1]	urn:cite:latepi:tokens.inperator
urn:cts:latepig:inscriptions.doc3.hclat:1@de[1]	urn:cite:latepi:tokens.de
urn:cts:latepig:inscriptions.doc3.hclat:1@rege[1]	urn:cite:latepi:tokens.rege
urn:cts:latepig:inscriptions.doc3.hclat:1@p[1]	urn:cite:latepi:tokens.p
urn:cts:latepig:inscriptions.doc3.hclat:1@erse[1]	urn:cite:latepi:tokens.erse
urn:cts:latepig:inscriptions.doc3.hclat:1@macedonibusque[1]	urn:cite:latepi:tokens.macedonibusque
urn:cts:latepig:inscriptions.doc3.hclat:1@cepet[1]	urn:cite:latepi:tokens.cepet
urn:cts:latepig:inscriptions.doc30.hclat:1@q[1]	urn:cite:latepi:tokens.q
urn:cts:latepig:inscriptions.doc30.hclat:1@quinto[1]	urn:cite:latepi:tokens.quinto
urn:cts:latepig:inscriptions.doc30.hclat:1@hortensio[1]	urn:cite:latepi:tokens.hortensio
urn:cts:latepig:inscriptions.doc30.hclat:2@q[1]	urn:cite:latepi:tokens.q
urn:cts:latepig:inscriptions.doc30.hclat:2@i[1]	urn:cite:latepi:tokens.i
urn:cts:latepig:inscriptions.doc30.hclat:2@col[1]	urn:cite:latepi:tokens.col
urn:cts:latepig:inscriptions.doc30.hclat:3@faustino[1]	urn:cite:latepi:tokens.faustino
urn:cts:latepig:inscriptions.doc30.hclat:4@advocato[1]	urn:cite:latepi:tokens.advocato
urn:cts:latepig:inscriptions.doc30.hclat:4@iis[1]	urn:cite:latepi:tokens.iis
urn:cts:latepig:inscriptions.doc30.hclat:5@ciprae[1]	urn:cite:latepi:tokens.ciprae
urn:cts:latepig:inscriptions.doc30.hclat:5@f[1]	urn:cite:latepi:tokens.f
urn:cts:latepig:inscriptions.doc30.hclat:5@filio[1]	urn:cite:latepi:tokens.filio
urn:cts:latepig:inscriptions.doc30.hclat:5@fabr[1]	urn:cite:latepi:tokens.fabr
urn:cts:latepig:inscriptions.doc30.hclat:5@fabrum[1]	urn:cite:latepi:tokens.fabrum
urn:cts:latepig:inscriptions.doc30.hclat:6@patrono[1]	urn:cite:latepi:tokens.patrono
urn:cts:latepig:inscriptions.doc30.hclat:6@municipi[1]	urn:cite:latepi:tokens.municipi
urn:cts:latepig:inscriptions.doc30.hclat:7@collegium[1]	urn:cite:latepi:tokens.collegium
urn:cts:latepig:inscriptions.doc30.hclat:7@fabrum[1]	urn:cite:latepi:tokens.fabrum
urn:cts:latepig:inscriptions.doc30.hclat:8@tiburtium[1]	urn:cite:latepi:tokens.tiburtium
urn:cts:latepig:inscriptions.doc30.hclat:8@ob[1]	urn:cite:latepi:tokens.ob
urn:cts:latepig:inscriptions.doc30.hclat:9@merita[1]	urn:cite:latepi:tokens.merita
urn:cts:latepig:inscriptions.doc30.hclat:10@l[1]	urn:cite:latepi:tokens.l
urn:cts:latepig:inscriptions.doc30.hclat:10@d[1]	urn:cite:latepi:tokens.d
urn:cts:latepig:inscriptions.doc30.hclat:10@s[1]	urn:cite:latepi:tokens.s
urn:cts:latepig:inscriptions.doc30.hclat:10@c[1]	urn:cite:latepi:tokens.c
urn:cts:latepig:inscriptions.doc31.hclat:1@iurius[1]	urn:cite:latepi:tokens.iurius
urn:cts:latepig:inscriptions.doc31.hclat:1@maeclus[1]	urn:cite:latepi:tokens.maeclus
urn:cts:latepig:inscriptions.doc31.hclat:2@gracchus[1]	urn:cite:latepi:tokens.gracchus
urn:cts:latepig:inscriptions.doc31.hclat:2@v[1]	urn:cite:latepi:tokens.v
urn:cts:latepig:inscriptions.doc31.hclat:2@c[1]	urn:cite:latepi:tokens.c
urn:cts:latepig:inscriptions.doc31.hclat:3@correctoria[1]	urn:cite:latepi:tokens.correctoria
urn:cts:latepig:inscriptions.doc31.hclat:4@miniae[1]	urn:cite:latepi:tokens.miniae
urn:cts:latepig:inscriptions.doc31.hclat:4@pice[1]	urn:cite:latepi:tokens.pice
urn:cts:latepig:inscriptions.doc31.hclat:6@thermarum[1]	urn:cite:latepi:tokens.thermarum
urn:cts:latepig:inscriptions.doc31.hclat:7@dedicavit[1]	urn:cite:latepi:tokens.dedicavit
urn:cts:latepig:inscriptions.doc32.hclat:1@parthenio[1]	urn:cite:latepi:tokens.parthenio
urn:cts:latepig:inscriptions.doc32.hclat:2@caesaris[1]	urn:cite:latepi:tokens.caesaris
urn:cts:latepig:inscriptions.doc32.hclat:3@ulpia[1]	urn:cite:latepi:tokens.ulpia
urn:cts:latepig:inscriptions.doc32.hclat:4@restituta[1]	urn:cite:latepi:tokens.restituta
urn:cts:latepig:inscriptions.doc32.hclat:5@uxor[1]	urn:cite:latepi:tokens.uxor
urn:cts:latepig:inscriptions.doc33.hclat:1@ragonio[1]	urn:cite:latepi:tokens.ragonio
urn:cts:latepig:inscriptions.doc33.hclat:1@vincentip[1]	urn:cite:latepi:tokens.vincentip
urn:cts:latepig:inscriptions.doc33.hclat:1@celso[1]	urn:cite:latepi:tokens.celso
urn:cts:latepig:inscriptions.doc33.hclat:1@c[1]	urn:cite:latepi:tokens.c
urn:cts:latepig:inscriptions.doc33.hclat:2@a[1]	urn:cite:latepi:tokens.a
urn:cts:latepig:inscriptions.doc33.hclat:2@primo[1]	urn:cite:latepi:tokens.primo
urn:cts:latepig:inscriptions.doc33.hclat:2@aetatis[1]	urn:cite:latepi:tokens.aetatis
urn:cts:latepig:inscriptions.doc33.hclat:2@intr[1]	urn:cite:latepi:tokens.intr
urn:cts:latepig:inscriptions.doc33.hclat:2@situ[1]	urn:cite:latepi:tokens.situ
urn:cts:latepig:inscriptions.doc33.hclat:2@in[1]	urn:cite:latepi:tokens.in
urn:cts:latepig:inscriptions.doc33.hclat:2@actu[1]	urn:cite:latepi:tokens.actu
urn:cts:latepig:inscriptions.doc33.hclat:3@publico[1]	urn:cite:latepi:tokens.publico
urn:cts:latepig:inscriptions.doc33.hclat:3@eideli[1]	urn:cite:latepi:tokens.eideli
urn:cts:latepig:inscriptions.doc33.hclat:3@exercitatione[1]	urn:cite:latepi:tokens.exercitatione
urn:cts:latepig:inscriptions.doc33.hclat:3@versato[1]	urn:cite:latepi:tokens.versato
urn:cts:latepig:inscriptions.doc33.hclat:4@cuius[1]	urn:cite:latepi:tokens.cuius
urn:cts:latepig:inscriptions.doc33.hclat:4@primae[1]	urn:cite:latepi:tokens.primae
urn:cts:latepig:inscriptions.doc33.hclat:4@vita[1]	urn:cite:latepi:tokens.vita
urn:cts:latepig:inscriptions.doc33.hclat:4@sofficios[1]	urn:cite:latepi:tokens.sofficios
urn:cts:latepig:inscriptions.doc33.hclat:4@edis[1]	urn:cite:latepi:tokens.edis
urn:cts:latepig:inscriptions.doc33.hclat:4@urbanae[1]	urn:cite:latepi:tokens.urbanae
urn:cts:latepig:inscriptions.doc33.hclat:5@advocationis[1]	urn:cite:latepi:tokens.advocationis
urn:cts:latepig:inscriptions.doc33.hclat:5@ex[1]	urn:cite:latepi:tokens.ex
urn:cts:latepig:inscriptions.doc33.hclat:5@epcito[1]	urn:cite:latepi:tokens.epcito
urn:cts:latepig:inscriptions.doc33.hclat:5@fidem[1]	urn:cite:latepi:tokens.fidem
urn:cts:latepig:inscriptions.doc33.hclat:5@genio[1]	urn:cite:latepi:tokens.genio
urn:cts:latepig:inscriptions.doc33.hclat:6@prudentiae[1]	urn:cite:latepi:tokens.prudentiae
urn:cts:latepig:inscriptions.doc33.hclat:6@miscuit[1]	urn:cite:latepi:tokens.miscuit
urn:cts:latepig:inscriptions.doc33.hclat:6@libertatem[1]	urn:cite:latepi:tokens.libertatem
urn:cts:latepig:inscriptions.doc33.hclat:6@tanti[1]	urn:cite:latepi:tokens.tanti
urn:cts:latepig:inscriptions.doc33.hclat:6@mod[1]	urn:cite:latepi:tokens.mod
urn:cts:latepig:inscriptions.doc33.hclat:7@pius[1]	urn:cite:latepi:tokens.pius
urn:cts:latepig:inscriptions.doc33.hclat:7@industrianisi[1]	urn:cite:latepi:tokens.industrianisi
urn:cts:latepig:inscriptions.doc33.hclat:7@ille[1]	urn:cite:latepi:tokens.ille
urn:cts:latepig:inscriptions.doc33.hclat:7@contra[1]	urn:cite:latepi:tokens.contra
urn:cts:latepig:inscriptions.doc33.hclat:7@ovem[1]	urn:cite:latepi:tokens.ovem
urn:cts:latepig:inscriptions.doc33.hclat:7@suscederat[1]	urn:cite:latepi:tokens.suscederat
urn:cts:latepig:inscriptions.doc33.hclat:8@formideret[1]	urn:cite:latepi:tokens.formideret
urn:cts:latepig:inscriptions.doc33.hclat:8@cuius[1]	urn:cite:latepi:tokens.cuius
urn:cts:latepig:inscriptions.doc33.hclat:8@accessi[1]	urn:cite:latepi:tokens.accessi
urn:cts:latepig:inscriptions.doc33.hclat:8@saetati[1]	urn:cite:latepi:tokens.saetati
urn:cts:latepig:inscriptions.doc33.hclat:8@samplissimi[1]	urn:cite:latepi:tokens.samplissimi
urn:cts:latepig:inscriptions.doc33.hclat:9@honoris[1]	urn:cite:latepi:tokens.honoris
urn:cts:latepig:inscriptions.doc33.hclat:9@et[1]	urn:cite:latepi:tokens.et
urn:cts:latepig:inscriptions.doc33.hclat:9@ovis[1]	urn:cite:latepi:tokens.ovis
urn:cts:latepig:inscriptions.doc33.hclat:9@olet[1]	urn:cite:latepi:tokens.olet
urn:cts:latepig:inscriptions.doc33.hclat:9@senior[1]	urn:cite:latepi:tokens.senior
urn:cts:latepig:inscriptions.doc33.hclat:9@ib[1]	urn:cite:latepi:tokens.ib
urn:cts:latepig:inscriptions.doc33.hclat:9@provenir[1]	urn:cite:latepi:tokens.provenir
urn:cts:latepig:inscriptions.doc33.hclat:9@poena[1]	urn:cite:latepi:tokens.poena
urn:cts:latepig:inscriptions.doc33.hclat:10@m[1]	urn:cite:latepi:tokens.m
urn:cts:latepig:inscriptions.doc33.hclat:10@promeruit[1]	urn:cite:latepi:tokens.promeruit
urn:cts:latepig:inscriptions.doc33.hclat:10@nam[1]	urn:cite:latepi:tokens.nam
urn:cts:latepig:inscriptions.doc33.hclat:10@rexit[1]	urn:cite:latepi:tokens.rexit
urn:cts:latepig:inscriptions.doc33.hclat:10@anno[1]	urn:cite:latepi:tokens.anno
urn:cts:latepig:inscriptions.doc33.hclat:10@nariam[1]	urn:cite:latepi:tokens.nariam
urn:cts:latepig:inscriptions.doc33.hclat:10@potis[1]	urn:cite:latepi:tokens.potis
urn:cts:latepig:inscriptions.doc33.hclat:11@tatem[1]	urn:cite:latepi:tokens.tatem
urn:cts:latepig:inscriptions.doc33.hclat:11@e[1]	urn:cite:latepi:tokens.e
urn:cts:latepig:inscriptions.doc33.hclat:11@bis[1]	urn:cite:latepi:tokens.bis
urn:cts:latepig:inscriptions.doc33.hclat:11@et[1]	urn:cite:latepi:tokens.et
urn:cts:latepig:inscriptions.doc33.hclat:11@nae[1]	urn:cite:latepi:tokens.nae
urn:cts:latepig:inscriptions.doc33.hclat:11@ea[1]	urn:cite:latepi:tokens.ea
urn:cts:latepig:inscriptions.doc33.hclat:11@eo[1]	urn:cite:latepi:tokens.eo
urn:cts:latepig:inscriptions.doc33.hclat:11@vita[1]	urn:cite:latepi:tokens.vita
urn:cts:latepig:inscriptions.doc33.hclat:11@eviin[1]	urn:cite:latepi:tokens.eviin
urn:cts:latepig:inscriptions.doc33.hclat:12@an[1]	urn:cite:latepi:tokens.an
urn:cts:latepig:inscriptions.doc33.hclat:12@holiticanis[1]	urn:cite:latepi:tokens.holiticanis
urn:cts:latepig:inscriptions.doc33.hclat:12@intrassent[1]	urn:cite:latepi:tokens.intrassent
urn:cts:latepig:inscriptions.doc33.hclat:12@parentem[1]	urn:cite:latepi:tokens.parentem
urn:cts:latepig:inscriptions.doc33.hclat:13@pleru[1]	urn:cite:latepi:tokens.pleru
urn:cts:latepig:inscriptions.doc33.hclat:13@magis[1]	urn:cite:latepi:tokens.magis
urn:cts:latepig:inscriptions.doc33.hclat:13@his[1]	urn:cite:latepi:tokens.his
urn:cts:latepig:inscriptions.doc33.hclat:13@ovam[1]	urn:cite:latepi:tokens.ovam
urn:cts:latepig:inscriptions.doc33.hclat:13@voi[1]	urn:cite:latepi:tokens.voi
urn:cts:latepig:inscriptions.doc33.hclat:13@cempraw[1]	urn:cite:latepi:tokens.cempraw
urn:cts:latepig:inscriptions.doc33.hclat:14@vincet[1]	urn:cite:latepi:tokens.vincet
urn:cts:latepig:inscriptions.doc33.hclat:14@iam[1]	urn:cite:latepi:tokens.iam
urn:cts:latepig:inscriptions.doc33.hclat:14@factum[1]	urn:cite:latepi:tokens.factum
urn:cts:latepig:inscriptions.doc33.hclat:14@est[1]	urn:cite:latepi:tokens.est
urn:cts:latepig:inscriptions.doc33.hclat:14@ut[1]	urn:cite:latepi:tokens.ut
urn:cts:latepig:inscriptions.doc33.hclat:14@mens[1]	urn:cite:latepi:tokens.mens
urn:cts:latepig:inscriptions.doc33.hclat:14@ores[1]	urn:cite:latepi:tokens.ores
urn:cts:latepig:inscriptions.doc33.hclat:15@vetus[1]	urn:cite:latepi:tokens.vetus
urn:cts:latepig:inscriptions.doc33.hclat:15@evitcum[1]	urn:cite:latepi:tokens.evitcum
urn:cts:latepig:inscriptions.doc33.hclat:15@candicariis[1]	urn:cite:latepi:tokens.candicariis
urn:cts:latepig:inscriptions.doc33.hclat:15@div[1]	urn:cite:latepi:tokens.div
urn:cts:latepig:inscriptions.doc33.hclat:16@iustamen[1]	urn:cite:latepi:tokens.iustamen
urn:cts:latepig:inscriptions.doc33.hclat:16@voti[1]	urn:cite:latepi:tokens.voti
urn:cts:latepig:inscriptions.doc33.hclat:16@con[1]	urn:cite:latepi:tokens.con
urn:cts:latepig:inscriptions.doc33.hclat:16@potes[1]	urn:cite:latepi:tokens.potes
urn:cts:latepig:inscriptions.doc33.hclat:16@abiremus[1]	urn:cite:latepi:tokens.abiremus
urn:cts:latepig:inscriptions.doc33.hclat:17@corpus[1]	urn:cite:latepi:tokens.corpus
urn:cts:latepig:inscriptions.doc33.hclat:17@et[1]	urn:cite:latepi:tokens.et
urn:cts:latepig:inscriptions.doc33.hclat:17@beneficiose[1]	urn:cite:latepi:tokens.beneficiose
urn:cts:latepig:inscriptions.doc33.hclat:17@et[2]	urn:cite:latepi:tokens.et
urn:cts:latepig:inscriptions.doc33.hclat:17@victori[1]	urn:cite:latepi:tokens.victori
urn:cts:latepig:inscriptions.doc33.hclat:17@crai[1]	urn:cite:latepi:tokens.crai
urn:cts:latepig:inscriptions.doc33.hclat:18@a[1]	urn:cite:latepi:tokens.a
urn:cts:latepig:inscriptions.doc33.hclat:18@dect[1]	urn:cite:latepi:tokens.dect
urn:cts:latepig:inscriptions.doc33.hclat:18@nam[1]	urn:cite:latepi:tokens.nam
urn:cts:latepig:inscriptions.doc33.hclat:18@ut[1]	urn:cite:latepi:tokens.ut
urn:cts:latepig:inscriptions.doc33.hclat:18@hoc[1]	urn:cite:latepi:tokens.hoc
urn:cts:latepig:inscriptions.doc33.hclat:18@esset[1]	urn:cite:latepi:tokens.esset
urn:cts:latepig:inscriptions.doc33.hclat:18@indicio[1]	urn:cite:latepi:tokens.indicio
urn:cts:latepig:inscriptions.doc33.hclat:19@magistratu[1]	urn:cite:latepi:tokens.magistratu
urn:cts:latepig:inscriptions.doc33.hclat:19@statuam[1]	urn:cite:latepi:tokens.statuam
urn:cts:latepig:inscriptions.doc33.hclat:19@patro[1]	urn:cite:latepi:tokens.patro
urn:cts:latepig:inscriptions.doc33.hclat:20@potesti[1]	urn:cite:latepi:tokens.potesti
urn:cts:latepig:inscriptions.doc33.hclat:20@monium[1]	urn:cite:latepi:tokens.monium
urn:cts:latepig:inscriptions.doc33.hclat:20@gratulationis[1]	urn:cite:latepi:tokens.gratulationis
urn:cts:latepig:inscriptions.doc33.hclat:21@nona[1]	urn:cite:latepi:tokens.nona
urn:cts:latepig:inscriptions.doc33.hclat:21@duiatione[1]	urn:cite:latepi:tokens.duiatione
urn:cts:latepig:inscriptions.doc33.hclat:21@privatos[1]	urn:cite:latepi:tokens.privatos
urn:cts:latepig:inscriptions.doc33.hclat:21@et[1]	urn:cite:latepi:tokens.et
urn:cts:latepig:inscriptions.doc33.hclat:22@tio[1]	urn:cite:latepi:tokens.tio
urn:cts:latepig:inscriptions.doc33.hclat:22@eto[1]	urn:cite:latepi:tokens.eto
urn:cts:latepig:inscriptions.doc33.hclat:22@vieter[1]	urn:cite:latepi:tokens.vieter
urn:cts:latepig:inscriptions.doc33.hclat:22@ed[1]	urn:cite:latepi:tokens.ed
urn:cts:latepig:inscriptions.doc33.hclat:22@datur[1]	urn:cite:latepi:tokens.datur
urn:cts:latepig:inscriptions.doc34.hclat:1@dedicata[1]	urn:cite:latepi:tokens.dedicata
urn:cts:latepig:inscriptions.doc34.hclat:1@viii[1]	urn:cite:latepi:tokens.viii
urn:cts:latepig:inscriptions.doc34.hclat:1@kal[1]	urn:cite:latepi:tokens.kal
urn:cts:latepig:inscriptions.doc34.hclat:1@kalendis[1]	urn:cite:latepi:tokens.kalendis
urn:cts:latepig:inscriptions.doc34.hclat:2@sept[1]	urn:cite:latepi:tokens.sept
urn:cts:latepig:inscriptions.doc34.hclat:2@septembribus[1]	urn:cite:latepi:tokens.septembribus
urn:cts:latepig:inscriptions.doc34.hclat:2@fl[1]	urn:cite:latepi:tokens.fl
urn:cts:latepig:inscriptions.doc34.hclat:2@flavio[1]	urn:cite:latepi:tokens.flavio
urn:cts:latepig:inscriptions.doc34.hclat:3@timasio[1]	urn:cite:latepi:tokens.timasio
urn:cts:latepig:inscriptions.doc34.hclat:3@et[1]	urn:cite:latepi:tokens.et
urn:cts:latepig:inscriptions.doc34.hclat:3@ei[1]	urn:cite:latepi:tokens.ei
urn:cts:latepig:inscriptions.doc34.hclat:3@promoto[1]	urn:cite:latepi:tokens.promoto
urn:cts:latepig:inscriptions.doc34.hclat:4@vvcc[1]	urn:cite:latepi:tokens.vvcc
urn:cts:latepig:inscriptions.doc34.hclat:4@viris[1]	urn:cite:latepi:tokens.viris
urn:cts:latepig:inscriptions.doc34.hclat:4@clarissimis[1]	urn:cite:latepi:tokens.clarissimis
urn:cts:latepig:inscriptions.doc34.hclat:4@conss[1]	urn:cite:latepi:tokens.conss
urn:cts:latepig:inscriptions.doc34.hclat:4@consulibus[1]	urn:cite:latepi:tokens.consulibus
urn:cts:latepig:inscriptions.doc35.hclat:1@genio[1]	urn:cite:latepi:tokens.genio
urn:cts:latepig:inscriptions.doc35.hclat:2@familiae[1]	urn:cite:latepi:tokens.familiae
urn:cts:latepig:inscriptions.doc35.hclat:2@monetal[1]	urn:cite:latepi:tokens.monetal
urn:cts:latepig:inscriptions.doc35.hclat:3@demetrius[1]	urn:cite:latepi:tokens.demetrius
urn:cts:latepig:inscriptions.doc35.hclat:3@caesaris[1]	urn:cite:latepi:tokens.caesaris
urn:cts:latepig:inscriptions.doc35.hclat:3@n[1]	urn:cite:latepi:tokens.n
urn:cts:latepig:inscriptions.doc35.hclat:3@nepos[1]	urn:cite:latepi:tokens.nepos
urn:cts:latepig:inscriptions.doc35.hclat:4@ser[1]	urn:cite:latepi:tokens.ser
urn:cts:latepig:inscriptions.doc35.hclat:4@servius[1]	urn:cite:latepi:tokens.servius
urn:cts:latepig:inscriptions.doc35.hclat:4@epaphroditianus[1]	urn:cite:latepi:tokens.epaphroditianus
urn:cts:latepig:inscriptions.doc35.hclat:4@disp[1]	urn:cite:latepi:tokens.disp
urn:cts:latepig:inscriptions.doc35.hclat:5@d[1]	urn:cite:latepi:tokens.d
urn:cts:latepig:inscriptions.doc35.hclat:5@d[2]	urn:cite:latepi:tokens.d
urn:cts:latepig:inscriptions.doc35.hclat:5@donum[1]	urn:cite:latepi:tokens.donum
urn:cts:latepig:inscriptions.doc35.hclat:5@dedit[1]	urn:cite:latepi:tokens.dedit
urn:cts:latepig:inscriptions.doc36.hclat:1@in[1]	urn:cite:latepi:tokens.in
urn:cts:latepig:inscriptions.doc36.hclat:1@his[1]	urn:cite:latepi:tokens.his
urn:cts:latepig:inscriptions.doc36.hclat:1@praed[1]	urn:cite:latepi:tokens.praed
urn:cts:latepig:inscriptions.doc36.hclat:1@i[1]	urn:cite:latepi:tokens.i
urn:cts:latepig:inscriptions.doc36.hclat:1@s[1]	urn:cite:latepi:tokens.s
urn:cts:latepig:inscriptions.doc36.hclat:2@insula[1]	urn:cite:latepi:tokens.insula
urn:cts:latepig:inscriptions.doc36.hclat:2@sertoriana[1]	urn:cite:latepi:tokens.sertoriana
urn:cts:latepig:inscriptions.doc36.hclat:3@bolo[1]	urn:cite:latepi:tokens.bolo
urn:cts:latepig:inscriptions.doc36.hclat:3@esse[1]	urn:cite:latepi:tokens.esse
urn:cts:latepig:inscriptions.doc36.hclat:3@aur[1]	urn:cite:latepi:tokens.aur
urn:cts:latepig:inscriptions.doc36.hclat:3@aurelio[1]	urn:cite:latepi:tokens.aurelio
urn:cts:latepig:inscriptions.doc36.hclat:3@cyriacetis[1]	urn:cite:latepi:tokens.cyriacetis
urn:cts:latepig:inscriptions.doc36.hclat:4@eilie[1]	urn:cite:latepi:tokens.eilie
urn:cts:latepig:inscriptions.doc36.hclat:4@meae[1]	urn:cite:latepi:tokens.meae
urn:cts:latepig:inscriptions.doc36.hclat:4@cinacula[1]	urn:cite:latepi:tokens.cinacula
urn:cts:latepig:inscriptions.doc36.hclat:4@n[1]	urn:cite:latepi:tokens.n
urn:cts:latepig:inscriptions.doc36.hclat:4@vi[1]	urn:cite:latepi:tokens.vi
urn:cts:latepig:inscriptions.doc36.hclat:4@tab[1]	urn:cite:latepi:tokens.tab
urn:cts:latepig:inscriptions.doc36.hclat:4@e[1]	urn:cite:latepi:tokens.e
urn:cts:latepig:inscriptions.doc36.hclat:4@rnas[1]	urn:cite:latepi:tokens.rnas
urn:cts:latepig:inscriptions.doc36.hclat:5@n[1]	urn:cite:latepi:tokens.n
urn:cts:latepig:inscriptions.doc36.hclat:5@x[1]	urn:cite:latepi:tokens.x
urn:cts:latepig:inscriptions.doc36.hclat:5@i[1]	urn:cite:latepi:tokens.i
urn:cts:latepig:inscriptions.doc36.hclat:5@et[1]	urn:cite:latepi:tokens.et
urn:cts:latepig:inscriptions.doc36.hclat:5@repossone[1]	urn:cite:latepi:tokens.repossone
urn:cts:latepig:inscriptions.doc36.hclat:5@subiscalibi[1]	urn:cite:latepi:tokens.subiscalibi
urn:cts:latepig:inscriptions.doc36.hclat:6@feliciter[1]	urn:cite:latepi:tokens.feliciter
urn:cts:latepig:inscriptions.doc37.hclat:1@saluti[1]	urn:cite:latepi:tokens.saluti
urn:cts:latepig:inscriptions.doc37.hclat:1@caesaris[1]	urn:cite:latepi:tokens.caesaris
urn:cts:latepig:inscriptions.doc37.hclat:1@august[1]	urn:cite:latepi:tokens.august
urn:cts:latepig:inscriptions.doc37.hclat:1@augusti[1]	urn:cite:latepi:tokens.augusti
urn:cts:latepig:inscriptions.doc37.hclat:2@glabrio[1]	urn:cite:latepi:tokens.glabrio
urn:cts:latepig:inscriptions.doc37.hclat:2@patronus[1]	urn:cite:latepi:tokens.patronus
urn:cts:latepig:inscriptions.doc37.hclat:2@coloniae[1]	urn:cite:latepi:tokens.coloniae
urn:cts:latepig:inscriptions.doc37.hclat:2@d[1]	urn:cite:latepi:tokens.d
urn:cts:latepig:inscriptions.doc37.hclat:2@d[2]	urn:cite:latepi:tokens.d
urn:cts:latepig:inscriptions.doc37.hclat:2@dono[1]	urn:cite:latepi:tokens.dono
urn:cts:latepig:inscriptions.doc37.hclat:2@dedit[1]	urn:cite:latepi:tokens.dedit
urn:cts:latepig:inscriptions.doc37.hclat:2@f[1]	urn:cite:latepi:tokens.f
urn:cts:latepig:inscriptions.doc37.hclat:2@c[1]	urn:cite:latepi:tokens.c
urn:cts:latepig:inscriptions.doc38.hclat:1@lodius[1]	urn:cite:latepi:tokens.lodius
urn:cts:latepig:inscriptions.doc38.hclat:1@primicinius[1]	urn:cite:latepi:tokens.primicinius
urn:cts:latepig:inscriptions.doc38.hclat:2@audius[1]	urn:cite:latepi:tokens.audius
urn:cts:latepig:inscriptions.doc38.hclat:2@crescens[1]	urn:cite:latepi:tokens.crescens
urn:cts:latepig:inscriptions.doc38.hclat:2@q[1]	urn:cite:latepi:tokens.q
urn:cts:latepig:inscriptions.doc38.hclat:2@q[2]	urn:cite:latepi:tokens.q
urn:cts:latepig:inscriptions.doc38.hclat:2@quinquennalis[1]	urn:cite:latepi:tokens.quinquennalis
urn:cts:latepig:inscriptions.doc38.hclat:3@siuppatores[1]	urn:cite:latepi:tokens.siuppatores
urn:cts:latepig:inscriptions.doc38.hclat:3@res[1]	urn:cite:latepi:tokens.res
urn:cts:latepig:inscriptions.doc39.hclat:1@corpus[1]	urn:cite:latepi:tokens.corpus
urn:cts:latepig:inscriptions.doc39.hclat:1@pel[1]	urn:cite:latepi:tokens.pel
urn:cts:latepig:inscriptions.doc39.hclat:2@liono[1]	urn:cite:latepi:tokens.liono
urn:cts:latepig:inscriptions.doc39.hclat:2@stepor[1]	urn:cite:latepi:tokens.stepor
urn:cts:latepig:inscriptions.doc39.hclat:3@ie[1]	urn:cite:latepi:tokens.ie
urn:cts:latepig:inscriptions.doc39.hclat:3@hic[1]	urn:cite:latepi:tokens.hic
urn:cts:latepig:inscriptions.doc4.hclat:1@d[1]	urn:cite:latepi:tokens.d
urn:cts:latepig:inscriptions.doc4.hclat:1@dis[1]	urn:cite:latepi:tokens.dis
urn:cts:latepig:inscriptions.doc4.hclat:1@m[1]	urn:cite:latepi:tokens.m
urn:cts:latepig:inscriptions.doc4.hclat:1@manibus[1]	urn:cite:latepi:tokens.manibus
urn:cts:latepig:inscriptions.doc4.hclat:2@tadia[1]	urn:cite:latepi:tokens.tadia
urn:cts:latepig:inscriptions.doc4.hclat:2@vallau[1]	urn:cite:latepi:tokens.vallau
urn:cts:latepig:inscriptions.doc4.hclat:2@mi[1]	urn:cite:latepi:tokens.mi
urn:cts:latepig:inscriptions.doc4.hclat:2@us[1]	urn:cite:latepi:tokens.us
urn:cts:latepig:inscriptions.doc4.hclat:2@vixit[1]	urn:cite:latepi:tokens.vixit
urn:cts:latepig:inscriptions.doc4.hclat:3@ann[1]	urn:cite:latepi:tokens.ann
urn:cts:latepig:inscriptions.doc4.hclat:3@anno[1]	urn:cite:latepi:tokens.anno
urn:cts:latepig:inscriptions.doc4.hclat:3@ixv[1]	urn:cite:latepi:tokens.ixv
urn:cts:latepig:inscriptions.doc4.hclat:3@et[1]	urn:cite:latepi:tokens.et
urn:cts:latepig:inscriptions.doc4.hclat:3@adius[1]	urn:cite:latepi:tokens.adius
urn:cts:latepig:inscriptions.doc4.hclat:3@exupertus[1]	urn:cite:latepi:tokens.exupertus
urn:cts:latepig:inscriptions.doc4.hclat:4@filius[1]	urn:cite:latepi:tokens.filius
urn:cts:latepig:inscriptions.doc4.hclat:4@vixit[1]	urn:cite:latepi:tokens.vixit
urn:cts:latepig:inscriptions.doc4.hclat:4@ann[1]	urn:cite:latepi:tokens.ann
urn:cts:latepig:inscriptions.doc4.hclat:4@anno[1]	urn:cite:latepi:tokens.anno
urn:cts:latepig:inscriptions.doc4.hclat:4@xxxvii[1]	urn:cite:latepi:tokens.xxxvii
urn:cts:latepig:inscriptions.doc4.hclat:4@det[1]	urn:cite:latepi:tokens.det
urn:cts:latepig:inscriptions.doc4.hclat:4@un[1]	urn:cite:latepi:tokens.un
urn:cts:latepig:inscriptions.doc4.hclat:5@tus[1]	urn:cite:latepi:tokens.tus
urn:cts:latepig:inscriptions.doc4.hclat:5@expeditione[1]	urn:cite:latepi:tokens.expeditione
urn:cts:latepig:inscriptions.doc4.hclat:5@germanica[1]	urn:cite:latepi:tokens.germanica
urn:cts:latepig:inscriptions.doc4.hclat:6@tadia[1]	urn:cite:latepi:tokens.tadia
urn:cts:latepig:inscriptions.doc4.hclat:6@exuperatea[1]	urn:cite:latepi:tokens.exuperatea
urn:cts:latepig:inscriptions.doc4.hclat:6@filia[1]	urn:cite:latepi:tokens.filia
urn:cts:latepig:inscriptions.doc4.hclat:7@matr[1]	urn:cite:latepi:tokens.matr
urn:cts:latepig:inscriptions.doc4.hclat:7@matri[1]	urn:cite:latepi:tokens.matri
urn:cts:latepig:inscriptions.doc4.hclat:7@et[1]	urn:cite:latepi:tokens.et
urn:cts:latepig:inscriptions.doc4.hclat:7@ratri[1]	urn:cite:latepi:tokens.ratri
urn:cts:latepig:inscriptions.doc4.hclat:7@piissma[1]	urn:cite:latepi:tokens.piissma
urn:cts:latepig:inscriptions.doc4.hclat:8@secustumulum[1]	urn:cite:latepi:tokens.secustumulum
urn:cts:latepig:inscriptions.doc4.hclat:9@patris[1]	urn:cite:latepi:tokens.patris
urn:cts:latepig:inscriptions.doc4.hclat:9@posuit[1]	urn:cite:latepi:tokens.posuit
urn:cts:latepig:inscriptions.doc40.hclat:1@navi[1]	urn:cite:latepi:tokens.navi
urn:cts:latepig:inscriptions.doc40.hclat:1@cui[1]	urn:cite:latepi:tokens.cui
urn:cts:latepig:inscriptions.doc40.hclat:1@ariorum[1]	urn:cite:latepi:tokens.ariorum
urn:cts:latepig:inscriptions.doc40.hclat:2@lignariorum[1]	urn:cite:latepi:tokens.lignariorum
urn:cts:latepig:inscriptions.doc41.hclat:1@navicula[1]	urn:cite:latepi:tokens.navicula
urn:cts:latepig:inscriptions.doc41.hclat:1@ric[1]	urn:cite:latepi:tokens.ric
urn:cts:latepig:inscriptions.doc41.hclat:1@urbi[1]	urn:cite:latepi:tokens.urbi
urn:cts:latepig:inscriptions.doc41.hclat:1@tanids[1]	urn:cite:latepi:tokens.tanids
urn:cts:latepig:inscriptions.doc42.hclat:1@p[1]	urn:cite:latepi:tokens.p
urn:cts:latepig:inscriptions.doc42.hclat:1@publio[1]	urn:cite:latepi:tokens.publio
urn:cts:latepig:inscriptions.doc42.hclat:1@nonio[1]	urn:cite:latepi:tokens.nonio
urn:cts:latepig:inscriptions.doc42.hclat:1@p[2]	urn:cite:latepi:tokens.p
urn:cts:latepig:inscriptions.doc42.hclat:1@publi[1]	urn:cite:latepi:tokens.publi
urn:cts:latepig:inscriptions.doc42.hclat:1@fil[1]	urn:cite:latepi:tokens.fil
urn:cts:latepig:inscriptions.doc42.hclat:1@filio[1]	urn:cite:latepi:tokens.filio
urn:cts:latepig:inscriptions.doc42.hclat:2@pal[1]	urn:cite:latepi:tokens.pal
urn:cts:latepig:inscriptions.doc42.hclat:2@livio[1]	urn:cite:latepi:tokens.livio
urn:cts:latepig:inscriptions.doc42.hclat:3@anterotiano[1]	urn:cite:latepi:tokens.anterotiano
urn:cts:latepig:inscriptions.doc42.hclat:4@equo[1]	urn:cite:latepi:tokens.equo
urn:cts:latepig:inscriptions.doc42.hclat:4@publ[1]	urn:cite:latepi:tokens.publ
urn:cts:latepig:inscriptions.doc42.hclat:4@publico[1]	urn:cite:latepi:tokens.publico
urn:cts:latepig:inscriptions.doc42.hclat:4@ex[1]	urn:cite:latepi:tokens.ex
urn:cts:latepig:inscriptions.doc42.hclat:4@ornato[1]	urn:cite:latepi:tokens.ornato
urn:cts:latepig:inscriptions.doc42.hclat:4@ab[1]	urn:cite:latepi:tokens.ab
urn:cts:latepig:inscriptions.doc42.hclat:5@imp[1]	urn:cite:latepi:tokens.imp
urn:cts:latepig:inscriptions.doc42.hclat:5@imperatore[1]	urn:cite:latepi:tokens.imperatore
urn:cts:latepig:inscriptions.doc42.hclat:5@m[1]	urn:cite:latepi:tokens.m
urn:cts:latepig:inscriptions.doc42.hclat:5@marco[1]	urn:cite:latepi:tokens.marco
urn:cts:latepig:inscriptions.doc42.hclat:5@aurelio[1]	urn:cite:latepi:tokens.aurelio
urn:cts:latepig:inscriptions.doc42.hclat:5@antonino[1]	urn:cite:latepi:tokens.antonino
urn:cts:latepig:inscriptions.doc42.hclat:5@aug[1]	urn:cite:latepi:tokens.aug
urn:cts:latepig:inscriptions.doc42.hclat:5@augusto[1]	urn:cite:latepi:tokens.augusto
urn:cts:latepig:inscriptions.doc42.hclat:6@dec[1]	urn:cite:latepi:tokens.dec
urn:cts:latepig:inscriptions.doc42.hclat:6@dec[2]	urn:cite:latepi:tokens.dec
urn:cts:latepig:inscriptions.doc42.hclat:6@decur[1]	urn:cite:latepi:tokens.decur
urn:cts:latepig:inscriptions.doc42.hclat:6@decreto[1]	urn:cite:latepi:tokens.decreto
urn:cts:latepig:inscriptions.doc42.hclat:6@decurionum[1]	urn:cite:latepi:tokens.decurionum
urn:cts:latepig:inscriptions.doc42.hclat:6@adlecto[1]	urn:cite:latepi:tokens.adlecto
urn:cts:latepig:inscriptions.doc42.hclat:7@flamini[1]	urn:cite:latepi:tokens.flamini
urn:cts:latepig:inscriptions.doc42.hclat:7@divi[1]	urn:cite:latepi:tokens.divi
urn:cts:latepig:inscriptions.doc42.hclat:7@hadriani[1]	urn:cite:latepi:tokens.hadriani
urn:cts:latepig:inscriptions.doc42.hclat:8@salio[1]	urn:cite:latepi:tokens.salio
urn:cts:latepig:inscriptions.doc42.hclat:8@laurent[1]	urn:cite:latepi:tokens.laurent
urn:cts:latepig:inscriptions.doc42.hclat:8@lavinativm[1]	urn:cite:latepi:tokens.lavinativm
urn:cts:latepig:inscriptions.doc42.hclat:9@aedili[1]	urn:cite:latepi:tokens.aedili
urn:cts:latepig:inscriptions.doc42.hclat:9@pr[1]	urn:cite:latepi:tokens.pr
urn:cts:latepig:inscriptions.doc42.hclat:9@praefecto[1]	urn:cite:latepi:tokens.praefecto
urn:cts:latepig:inscriptions.doc42.hclat:9@sacr[1]	urn:cite:latepi:tokens.sacr
urn:cts:latepig:inscriptions.doc42.hclat:9@voli[1]	urn:cite:latepi:tokens.voli
urn:cts:latepig:inscriptions.doc42.hclat:9@faciv[1]	urn:cite:latepi:tokens.faciv
urn:cts:latepig:inscriptions.doc42.hclat:10@t[1]	urn:cite:latepi:tokens.t
urn:cts:latepig:inscriptions.doc42.hclat:10@titus[1]	urn:cite:latepi:tokens.titus
urn:cts:latepig:inscriptions.doc42.hclat:10@tinucius[1]	urn:cite:latepi:tokens.tinucius
urn:cts:latepig:inscriptions.doc42.hclat:11@sosiphanes[1]	urn:cite:latepi:tokens.sosiphanes
urn:cts:latepig:inscriptions.doc42.hclat:12@carissimo[1]	urn:cite:latepi:tokens.carissimo
urn:cts:latepig:inscriptions.doc42.hclat:13@pientissimo[1]	urn:cite:latepi:tokens.pientissimo
urn:cts:latepig:inscriptions.doc42.hclat:14@l[1]	urn:cite:latepi:tokens.l
urn:cts:latepig:inscriptions.doc42.hclat:14@d[1]	urn:cite:latepi:tokens.d
urn:cts:latepig:inscriptions.doc42.hclat:14@d[2]	urn:cite:latepi:tokens.d
urn:cts:latepig:inscriptions.doc42.hclat:14@d[3]	urn:cite:latepi:tokens.d
urn:cts:latepig:inscriptions.doc42.hclat:14@p[1]	urn:cite:latepi:tokens.p
urn:cts:latepig:inscriptions.doc5.hclat:1@imp[1]	urn:cite:latepi:tokens.imp
urn:cts:latepig:inscriptions.doc5.hclat:1@imperatori[1]	urn:cite:latepi:tokens.imperatori
urn:cts:latepig:inscriptions.doc5.hclat:1@caes[1]	urn:cite:latepi:tokens.caes
urn:cts:latepig:inscriptions.doc5.hclat:1@caesari[1]	urn:cite:latepi:tokens.caesari
urn:cts:latepig:inscriptions.doc5.hclat:1@di[1]	urn:cite:latepi:tokens.di
urn:cts:latepig:inscriptions.doc5.hclat:1@vi[1]	urn:cite:latepi:tokens.vi
urn:cts:latepig:inscriptions.doc5.hclat:1@nervae[1]	urn:cite:latepi:tokens.nervae
urn:cts:latepig:inscriptions.doc5.hclat:1@f[1]	urn:cite:latepi:tokens.f
urn:cts:latepig:inscriptions.doc5.hclat:1@filio[1]	urn:cite:latepi:tokens.filio
urn:cts:latepig:inscriptions.doc5.hclat:2@nervae[1]	urn:cite:latepi:tokens.nervae
urn:cts:latepig:inscriptions.doc5.hclat:2@trai[1]	urn:cite:latepi:tokens.trai
urn:cts:latepig:inscriptions.doc5.hclat:2@ano[1]	urn:cite:latepi:tokens.ano
urn:cts:latepig:inscriptions.doc5.hclat:2@aug[1]	urn:cite:latepi:tokens.aug
urn:cts:latepig:inscriptions.doc5.hclat:2@augusto[1]	urn:cite:latepi:tokens.augusto
urn:cts:latepig:inscriptions.doc5.hclat:3@ger[1]	urn:cite:latepi:tokens.ger
urn:cts:latepig:inscriptions.doc5.hclat:3@germanico[1]	urn:cite:latepi:tokens.germanico
urn:cts:latepig:inscriptions.doc5.hclat:3@pontif[1]	urn:cite:latepi:tokens.pontif
urn:cts:latepig:inscriptions.doc5.hclat:3@pontifici[1]	urn:cite:latepi:tokens.pontifici
urn:cts:latepig:inscriptions.doc5.hclat:3@maxim[1]	urn:cite:latepi:tokens.maxim
urn:cts:latepig:inscriptions.doc5.hclat:3@o[1]	urn:cite:latepi:tokens.o
urn:cts:latepig:inscriptions.doc5.hclat:3@trib[1]	urn:cite:latepi:tokens.trib
urn:cts:latepig:inscriptions.doc5.hclat:3@tribuno[1]	urn:cite:latepi:tokens.tribuno
urn:cts:latepig:inscriptions.doc5.hclat:4@potest[1]	urn:cite:latepi:tokens.potest
urn:cts:latepig:inscriptions.doc5.hclat:4@potestate[1]	urn:cite:latepi:tokens.potestate
urn:cts:latepig:inscriptions.doc5.hclat:4@p[1]	urn:cite:latepi:tokens.p
urn:cts:latepig:inscriptions.doc5.hclat:4@p[2]	urn:cite:latepi:tokens.p
urn:cts:latepig:inscriptions.doc5.hclat:4@patri[1]	urn:cite:latepi:tokens.patri
urn:cts:latepig:inscriptions.doc5.hclat:4@patriae[1]	urn:cite:latepi:tokens.patriae
urn:cts:latepig:inscriptions.doc5.hclat:5@cos[1]	urn:cite:latepi:tokens.cos
urn:cts:latepig:inscriptions.doc5.hclat:5@consul[1]	urn:cite:latepi:tokens.consul
urn:cts:latepig:inscriptions.doc5.hclat:5@iii[1]	urn:cite:latepi:tokens.iii
urn:cts:latepig:inscriptions.doc5.hclat:6@leg[1]	urn:cite:latepi:tokens.leg
urn:cts:latepig:inscriptions.doc5.hclat:6@legato[1]	urn:cite:latepi:tokens.legato
urn:cts:latepig:inscriptions.doc5.hclat:6@ii[1]	urn:cite:latepi:tokens.ii
urn:cts:latepig:inscriptions.doc5.hclat:6@aug[1]	urn:cite:latepi:tokens.aug
urn:cts:latepig:inscriptions.doc5.hclat:6@augusto[1]	urn:cite:latepi:tokens.augusto
urn:cts:latepig:inscriptions.doc6.hclat:1@impp[1]	urn:cite:latepi:tokens.impp
urn:cts:latepig:inscriptions.doc6.hclat:1@imperatores[1]	urn:cite:latepi:tokens.imperatores
urn:cts:latepig:inscriptions.doc6.hclat:1@valerianus[1]	urn:cite:latepi:tokens.valerianus
urn:cts:latepig:inscriptions.doc6.hclat:1@et[1]	urn:cite:latepi:tokens.et
urn:cts:latepig:inscriptions.doc6.hclat:1@gallienus[1]	urn:cite:latepi:tokens.gallienus
urn:cts:latepig:inscriptions.doc6.hclat:2@augg[1]	urn:cite:latepi:tokens.augg
urn:cts:latepig:inscriptions.doc6.hclat:2@augusti[1]	urn:cite:latepi:tokens.augusti
urn:cts:latepig:inscriptions.doc6.hclat:2@et[1]	urn:cite:latepi:tokens.et
urn:cts:latepig:inscriptions.doc6.hclat:2@valerianus[1]	urn:cite:latepi:tokens.valerianus
urn:cts:latepig:inscriptions.doc6.hclat:2@nobilissimus[1]	urn:cite:latepi:tokens.nobilissimus
urn:cts:latepig:inscriptions.doc6.hclat:3@caes[1]	urn:cite:latepi:tokens.caes
urn:cts:latepig:inscriptions.doc6.hclat:3@caesar[1]	urn:cite:latepi:tokens.caesar
urn:cts:latepig:inscriptions.doc6.hclat:3@cohorti[1]	urn:cite:latepi:tokens.cohorti
urn:cts:latepig:inscriptions.doc6.hclat:3@vii[1]	urn:cite:latepi:tokens.vii
urn:cts:latepig:inscriptions.doc6.hclat:3@centurias[1]	urn:cite:latepi:tokens.centurias
urn:cts:latepig:inscriptions.doc6.hclat:3@a[1]	urn:cite:latepi:tokens.a
urn:cts:latepig:inscriptions.doc6.hclat:3@so[1]	urn:cite:latepi:tokens.so
urn:cts:latepig:inscriptions.doc6.hclat:4@lo[1]	urn:cite:latepi:tokens.lo
urn:cts:latepig:inscriptions.doc6.hclat:4@restituerunt[1]	urn:cite:latepi:tokens.restituerunt
urn:cts:latepig:inscriptions.doc6.hclat:4@per[1]	urn:cite:latepi:tokens.per
urn:cts:latepig:inscriptions.doc6.hclat:4@desticium[1]	urn:cite:latepi:tokens.desticium
urn:cts:latepig:inscriptions.doc6.hclat:4@iubam[1]	urn:cite:latepi:tokens.iubam
urn:cts:latepig:inscriptions.doc6.hclat:5@v[1]	urn:cite:latepi:tokens.v
urn:cts:latepig:inscriptions.doc6.hclat:5@c[1]	urn:cite:latepi:tokens.c
urn:cts:latepig:inscriptions.doc6.hclat:5@viri[1]	urn:cite:latepi:tokens.viri
urn:cts:latepig:inscriptions.doc6.hclat:5@clarissimi[1]	urn:cite:latepi:tokens.clarissimi
urn:cts:latepig:inscriptions.doc6.hclat:5@legatum[1]	urn:cite:latepi:tokens.legatum
urn:cts:latepig:inscriptions.doc6.hclat:5@augg[1]	urn:cite:latepi:tokens.augg
urn:cts:latepig:inscriptions.doc6.hclat:5@augusti[1]	urn:cite:latepi:tokens.augusti
urn:cts:latepig:inscriptions.doc6.hclat:5@pr[1]	urn:cite:latepi:tokens.pr
urn:cts:latepig:inscriptions.doc6.hclat:5@pr[2]	urn:cite:latepi:tokens.pr
urn:cts:latepig:inscriptions.doc6.hclat:5@praefecto[1]	urn:cite:latepi:tokens.praefecto
urn:cts:latepig:inscriptions.doc6.hclat:5@praetorio[1]	urn:cite:latepi:tokens.praetorio
urn:cts:latepig:inscriptions.doc6.hclat:5@et[1]	urn:cite:latepi:tokens.et
urn:cts:latepig:inscriptions.doc6.hclat:6@vitulasium[1]	urn:cite:latepi:tokens.vitulasium
urn:cts:latepig:inscriptions.doc6.hclat:6@laetinianum[1]	urn:cite:latepi:tokens.laetinianum
urn:cts:latepig:inscriptions.doc6.hclat:6@eg[1]	urn:cite:latepi:tokens.eg
urn:cts:latepig:inscriptions.doc6.hclat:6@eg[2]	urn:cite:latepi:tokens.eg
urn:cts:latepig:inscriptions.doc6.hclat:7@ii[1]	urn:cite:latepi:tokens.ii
urn:cts:latepig:inscriptions.doc6.hclat:7@aug[1]	urn:cite:latepi:tokens.aug
urn:cts:latepig:inscriptions.doc6.hclat:7@curante[1]	urn:cite:latepi:tokens.curante
urn:cts:latepig:inscriptions.doc6.hclat:7@domit[1]	urn:cite:latepi:tokens.domit
urn:cts:latepig:inscriptions.doc6.hclat:7@potentino[1]	urn:cite:latepi:tokens.potentino
urn:cts:latepig:inscriptions.doc6.hclat:8@praete[1]	urn:cite:latepi:tokens.praete
urn:cts:latepig:inscriptions.doc6.hclat:8@praetore[1]	urn:cite:latepi:tokens.praetore
urn:cts:latepig:inscriptions.doc6.hclat:8@leg[1]	urn:cite:latepi:tokens.leg
urn:cts:latepig:inscriptions.doc6.hclat:8@legato[1]	urn:cite:latepi:tokens.legato
urn:cts:latepig:inscriptions.doc6.hclat:8@eiusdem[1]	urn:cite:latepi:tokens.eiusdem
urn:cts:latepig:inscriptions.doc7.hclat:1@caesares[1]	urn:cite:latepi:tokens.caesares
urn:cts:latepig:inscriptions.doc7.hclat:1@l[1]	urn:cite:latepi:tokens.l
urn:cts:latepig:inscriptions.doc7.hclat:1@lucius[1]	urn:cite:latepi:tokens.lucius
urn:cts:latepig:inscriptions.doc7.hclat:1@septi[1]	urn:cite:latepi:tokens.septi
urn:cts:latepig:inscriptions.doc7.hclat:1@septimius[1]	urn:cite:latepi:tokens.septimius
urn:cts:latepig:inscriptions.doc7.hclat:2@aug[1]	urn:cite:latepi:tokens.aug
urn:cts:latepig:inscriptions.doc7.hclat:2@augustus[1]	urn:cite:latepi:tokens.augustus
urn:cts:latepig:inscriptions.doc7.hclat:2@et[1]	urn:cite:latepi:tokens.et
urn:cts:latepig:inscriptions.doc7.hclat:2@p[1]	urn:cite:latepi:tokens.p
urn:cts:latepig:inscriptions.doc7.hclat:2@publius[1]	urn:cite:latepi:tokens.publius
urn:cts:latepig:inscriptions.doc7.hclat:2@septimius[1]	urn:cite:latepi:tokens.septimius
urn:cts:latepig:inscriptions.doc7.hclat:3@corruptum[1]	urn:cite:latepi:tokens.corruptum
urn:cts:latepig:inscriptions.doc8.hclat:1@t[1]	urn:cite:latepi:tokens.t
urn:cts:latepig:inscriptions.doc8.hclat:1@titi[1]	urn:cite:latepi:tokens.titi
urn:cts:latepig:inscriptions.doc8.hclat:1@fl[1]	urn:cite:latepi:tokens.fl
urn:cts:latepig:inscriptions.doc8.hclat:1@filius[1]	urn:cite:latepi:tokens.filius
urn:cts:latepig:inscriptions.doc8.hclat:1@postumius[1]	urn:cite:latepi:tokens.postumius
urn:cts:latepig:inscriptions.doc8.hclat:2@varus[1]	urn:cite:latepi:tokens.varus
urn:cts:latepig:inscriptions.doc8.hclat:2@v[1]	urn:cite:latepi:tokens.v
urn:cts:latepig:inscriptions.doc8.hclat:2@c[1]	urn:cite:latepi:tokens.c
urn:cts:latepig:inscriptions.doc8.hclat:2@vir[1]	urn:cite:latepi:tokens.vir
urn:cts:latepig:inscriptions.doc8.hclat:2@clarissimus[1]	urn:cite:latepi:tokens.clarissimus
urn:cts:latepig:inscriptions.doc8.hclat:2@leg[1]	urn:cite:latepi:tokens.leg
urn:cts:latepig:inscriptions.doc8.hclat:2@legatus[1]	urn:cite:latepi:tokens.legatus
urn:cts:latepig:inscriptions.doc8.hclat:3@templ[1]	urn:cite:latepi:tokens.templ
urn:cts:latepig:inscriptions.doc8.hclat:3@templum[1]	urn:cite:latepi:tokens.templum
urn:cts:latepig:inscriptions.doc8.hclat:3@dianae[1]	urn:cite:latepi:tokens.dianae
urn:cts:latepig:inscriptions.doc8.hclat:4@restituit[1]	urn:cite:latepi:tokens.restituit
urn:cts:latepig:inscriptions.doc9.hclat:1@hermese[1]	urn:cite:latepi:tokens.hermese
